# ###################################################################################################################################################################
# ##    #   ##     ## #  # #            ####        # # #         ## # #          # ##     #### # #  # # ## ##     #  # ## ## # # ####  # # ##  ##      ## #        #
#  ####   ###  ### #    ## ### ########  ##  ###### # # ### # ## ###   ########## # ######  ##  #   ##       ##### # ##  # ##      ##  ##    # ##  ## ####   ## # ###
## ## ###   ###### ## ####  #####   ####  ####      # #  ######    ## #### ## #      # #   #### # ######## ###       ## ##  ### ###### ##### #  ## ####  ### ###### #
## #   ### ## ##   ## ## ##  ## ### #  ## # ####### # # ## #  ## ###  ## # #  #### #   ## ###      # ## ##  ######## #  ## ## # # ## #  ##     ##    #  #### # # ## #
#  # ### # ## #### ## #  ## ##  ##  ##    # # ## #    # ##   ##    # ### # # ## #  ###      ### ##    # #  ##        # ##  ## #    # # #### ###### ### ##  #      # #
##       # ##  # # ## # ##  #  ##  #### #      # #### # ####  #### # ##         ## #   #### # # ####### ##  ######## # ### #  # ####     ##  ## ## # #  ##   ###### #
#  # ###    ## #   ## #  ## ##  ## ## #### ###   # #     # ## ##   # ### ## ###  # ### ##   # #  ## # # ## ## # # ## # # # # ##    #### ####  #        #####    ##  #
# ####   # ##  ### ##   ##  ###  # ## ## ##### #   ##### # ##  # #    ## ###### ## ########   # ##  #   #  ## # # #    #   # ## ## # #   # ## # ######### ## ###### #
#  ####### ### ##   ###  ##  ### # ##  # ##  ##### ### #    ## ##### ##### #  # #### ###    #    ## # ### ##    # #### ## ## #  #### ## ## #       # ###  ## #  ##  #
#### ## #       ## ##   ##  ##      ##    ## ## ## # # ### ##   ## # ## #  ## #  ##  # ####### #### # #   ##### # ## # #   #   ## #  ## ## ### #####   ## ## # ##  ##
#    ## ## ## #     ### ### #  ####  #### ## #     #   # # ####       # ##    # #### # ###     # #    # ### ##    ## # ## ## ###    ##  #       ## # ###   # #    ###
#### #  ####### # # #    ## ####  ## #  # ## ##### ###      ######### # #####    ##  # # ##### # # ####  ## #  ##              ### #### ## ####### # # ###     #### #
# ## ## # ## ###### #### #   #### ## ##   ## # #     ##### ## ##  #           ###### #   # # #     # ## ##  ######## ## ### #### #  # # ##    ## # #     # ######   #
# #             ### # ## ### #        ## ##      # #        #  ## ########### ##  ## ### # # ### ### ##  ##  ## #  ###### #      # ## # #  ##### # # ##### ####   ###
#   ## ####### ##     ##   # ### ####    ### ### ##########   ###  # #         ## #           #   ## ## #### #  ## ## ##    ###### ## # # ###  # #      #       #####
## ##  #        ### #    #       #######   #######     # ## ### ## # #########  # ########### ## ##  ## # ## # ##  #   # ##### # # ## #   # # ## # ###### ## # ##   #
#   ## ## #####     #### # ## # ##       ##### #######      # # ## # ## ##     ## # ##  ##        # ###   ## #  ## # #    #      # #  # ### # ##    ## #   ######## #
# # ##  ####    ## ####### ########### #  ## # # # ######## #    # # ##  ### # ##    ##  ######## # #   # ## # ##  #### # # ###### ## #  ##   ## ####    #  # # #   #
# # #  ##    # ### #    ####    ## ######        # # ##     ####   #  # ## ###  #### ## ## #          # ###    ## ### ###   ## ##       ### ####  ### # ###   # # ###
##### ###### # #   # ##   #### ##    ## # # ## #        # #      #   ##  #  #  ## ## ## ## ######## # ######## ## ##   ## ###  ####### ###   ##  ## # ### #####   # #
####### ## ##############      ##### #  ########### # ### ## # # ###  ## ##   ##     ## ## ## ##### #  ## # ## ##  ### #    ## # #  ## ##  #  ## ## #   #  #    #   #
# # ##        ##    ########## #  ## ## ## ## #  #  ###   #  ### ####     ## ####### ##  # #        ##### # #   ## ##  ## #### # ##    ## #####       ### ## ########
#   ###### ##    ##  ##   #### # ##  ## ## ## ## ## ### # # ##   #  ## ##  # # #        ## ## ##### ##  # # ### ## #  ##   ##    #####  # # # ## ####  #   #   # #  #
### #      #  # #### #  #         ##       ##     # # # ########### ######     # # ### ###  # #   #  ## # # # # ##   #####  ### ##   ## # # #       ##   ### ### # ##
# # #### #### ### #    ## # # # #    #### ###### #### ###### #  #    ## #  ## ######   # ## #####   ##  # # # # #  # # # # ##    ## ##    #   ## ##### #       #    #
# # ####### ###     ## #  # ###### #####   ## ## # #   ## #  ## ####  #   ##    # #### # #   # ### #### # #     ## ### # # #### ##  ### ### ###      # # # # #   ####
# # #  ## # #   ## ######## ## # # #     #  #  #   ### ## ## ##  ####   # ### #          # ### # #  ##  # ##### #  ### #     ##  ##   #     ##### ########## ## ### #
# # # ##  # # #### # ##  ## #    ### ###### ## # ##### ## #  ### #  ## ##  ## ##########   # # # # ####   # #     ## # ### #### ##### ## #### # #### ####  # #      #
#        ## ####   #  ##  ######  ######       # # #    # ##  #  # #######  ### ###      #         ##   ### #####  # #  #   ##   # #  #          #   # #  ##### # ###
### # ## #   # ##### #### ## ##  ## #  #######   # ####   ### ##    # ########      # # #### ### #  ### ##  # #   ## ## ### #### # ## # ########## ### # ## # ###   #
#   ###    #                 ### #  ##  ###### # # #  # ###      ##    ##### ## ##### # #    ##  ## # #  ## # ## ##  #   #   ##    ## #                         # # #
# # #   # ## ### ## # ## ### # # ## ## ##      #   ## # # #### #######  ##      ## ################     ##    #   ## ### # #######  # # ######### ############# # # #
####### # ## ##   #####  ##    #       ## ## # ###      # #### #       ##########    # # # ## ### #####  #### # ###   ##      #  ## # # #     ### ####       #### # #
#       # #   ## ##     ##  ##   ## ##  ########## # ##      #########   # #  ##  # ##   # ## #    ## ##  ##    ##  ###  # #### ##        # # # #      ## ##    # ###
###### ##### #####  # ###  ##### #   ## ## ##### #####  #### ## ## ##### # ## #####  ### # #  #### #   ##  ####  ## ##  ## ## # ## # ### ###### #### # ##  # # ######
###     ##   ###### # #   ##     #####     # # #  # #######      #    #  # ##  ##   ##   # ##   ##   #####    ##  # ## ######   #### ##### # #  #### #  ## ###   ## #
# ##########  ## ############## #####  # #       ##       ###### #### ## # #  ##### #### # #### #  # # # ## ###  ## ##    ##  ### #            ##  ################ #
# # ###  ### ##     ### #       ##    ## ## # # ######### # ##   #         ##  ## #  ##           ##          ##  #  # ####  ###    ## #########  ### # #     ####  #
#     ## # # ##### ##     ### ###  # ##  ###### # ###   #    ### #### # # ### ##  ## ## ## ### ############## #  ## ## # ### # ## ###   # ## ##  ##       #####    ##
### #    # ### #      ################# ## #    # # ### ### ##     #### #  #   ## ##  ######## ### ####     # # ### #  #  #         ###         #### ###### # # #####
#   ## #    ## # # ## ##         ##     #    ##              ### ### ##### ### #   ## ### ## # #      #####     # # # ## ## ### # #   # ##### #### #             #  #
###  ######  # # #### #  ###### ##  ### ########## ######## ## # # # # # # ##    #         # ########       ## ## #          ## #######   ###### # # ##### ### #   ##
# ## ## #### # #### #### #         ######          ##                      ##### ## # #### # ##     #### # ##   #   # # ## #  ####    # #    #        # ##########  #
# ####          ##  ## ######## # ##      # ##### #### ######## # # ### ##   ##  ## # #      ###### #### ######   ### #  # ##  ##  ####### #   ### ##         #  ## #
# # #  ########  ## ## ### ############ ### #      ##  #        # ###    ###    ##  # #### #  # #   #  #### #   #  ## ########    ## #  ## # # ###### ###### ## #####
# #   ##      ## ## #            ## ###   ##### ##  ## ###### # ##########   ## ## ####### ## # ### ##  ##    # # ##      #### ##    # #########    #    ######     #
#   # ### # #         # ###### #    #   #### #   #######      # ##  # #    # ##  ### #     #    ### ###  #### # #  ## # #  ##   ## #       ## ### #### #      ## ####
# # #  ######### # ######      ## #   # ##     ###    #  ## # #####     ## # #  ##   ##########         ##    # # ### # # ##  # #### # # #     #    ##### #####     #
# ######         ###      ## ####### ##  #### #### ## ## #  #   # # # #  ### ## ## #            ## # ##    ## # #   ### ##### #  ########## ##   # ## ######    ## ##
# #  #############   ## # #  #       ##### ##### ###   #### # # #   ### ##   ## ###### # ## # # #  #  ## # ## # ## ####    ## ##        # #  # ###     # ##  # ######
####   #           ###  #### ### ### #            #### ###  ### ## ##   ## # ## #  ############ #### ### # ## # #     # ####   # #### #   # ##  ## ## ##    ##  # # #
###### #### ## ## ######## #######   ## ######## ##        ##   ## #  # #  # #### ##  # ## # ## ##   #   #  # #### # ##    ## ## ######## #  ########### ######     #
# # #        #### ##       ### ##########         #### # #  # # #### ##### # # #  ### # #       ## # # # # ##  ##  ###  # ### ##        ######  # #####    #  ## ####
#     ## ## ##     ##### #   # # # ### #  #######      # # ## # # ## ##    ###   ## #   ####### ## # ### # ###  ##  #####   ###  ## ###### # ##    ##   ##   ###    #
#### ##  ####### #####   ### #       # ####  # ### # # # # ## ###    ## ## #####      #         #  #   ###  ## ####  # ## #   #####             ####  ###  # # ######
#     #### #   #  ## #######   # # #    ####       # # # #  ###   # ######## #### ########## # ## ## ####  ##    ###    # # #     # # ## # # ##      ##### #      ###
####### ## ###   ##    #     ##########      # # # # # ####   ### # ##         #  #          ###   ###    #### ### # # ############## ## # #  # # ##    ##### ###   #
#              ####### ### #### # # #   # ## ####### # ##   ### # # ##### # ##   #### #### ####  #   ## #  # # #     # #       # # ##  # ### ## #  ## #   ##    ## ##
### ### ## ## ####     ##  ##     #   # ###   ##     # #  #  ##   ### #   ##### ##    ##   #    ## # ## ##   # # ## ##   ### #      # ##  ##  # # ########### ####  #
#####    ######  ##### ########## ### ###### ###### ## ## ####### ##    # ##     ## #  ### ## #  # # ####### # # ##### ##### ## # ########## ## # #     ### #    # ##
#   #### #  ####  ## #   ## #         ##     ##      ######    ######## ##### # ##### ##   #### ## ###       # #  ##       # ## #    ## #  # ## #   ##### # #### #  #
# ######### # ### #  # ###  ####### # ## # #  ## ## ### ######   ## # ########### ##  ## # #     #   ## ### ## # #### # # ## ## # ##  #   ## ## # #          ########
# # #   # # # #   ## #  ### # ## #### ## ### ##  ## # # # ###### ##    ## ## # #   # ########### # #  ##### ## ###  ### ######  # ###   #  # ## #### #### # ## #### #
# # ### #     ###  #   ##          ##  #####  ## #  #        #    #### ## #    ###   # ###       #### ##     #     ##        ####  ## ### ## ##  ##     # #  # # #  #
# # # # ### #  ### ### ### ##### #    ###    ##### ######### #### # ##  #   ##     # # # #### ##  # ###  # # ## # ###### # #    # ##    #  ###  ##### ##### ##     ##
#   #    #####             ##    #### ##  # ## #   #       # ##   # ###   ###  ## ####        ###     ## ###  # #  ##    ##### ##  ## #########  # ##  # ##    # # ##
# #   # ## ##  ### # ## ##  #######    ## # ##   #### #### #  ###    ## ####  ##  ##   # ### ## ## # ##  ##  ## ## ### #   ##########  # # #  ##    ##    # # ## #  #
# # ### #   ## ##  # #  ## ##       # ##  ##### ### ###      ###  ##    #  ###### ###### #   #     #  ##  ##  ###### # # #    ## # #  ##     ##  # ##  # ## ###### ##
# # #     #     ## # ## #  ### # # ##  ####  #####      ####  #  ##### ###  ## #  # ###  ## ### # ## ########  ##      ### ##  # # ##    ## ##  ###### # ##     ##  #
########### ###### # ## ## # ### #### ######  #  ## ### #  ##   ##     # ##      ## # ## #    ### ##      ##  #### # # ###  ##     ## ##  #  ##   # ## # ## # ###  ##
## # #        ##   # #  ## # #    ##  #   ### ## #####  ##  ### ### # ## ### # # #     ########    # ## #####   ## # # #   ##  ## ##  ## #####  #   ######  # ### ###
#      # # ## ##############   ## #######         ## ######       #####      ######### ## ## #  # ##  ###     # #  # #####  ##  # ###  #     ## ## ##    ####   ### #
## ## ####  ###  ## # ## ##### ####     ### # ### #  # ## # # # ###  ###### ##                 ##  ##   ### # # ## #### #  ##  ## #   #### ###  ##    # ##    #     #
#  #####   ##   ##     # #        ### #     # ##  ## # #    # ######    ############## ## ## # ## #### #### ###### #      ##  ##  ###    #   ## ## ## #  ### #### ###
#### # ###  ###  ## ##     ## # ######## # ######        ######   #### ## #   #        ## #  # ## ## ####      # # ## ###  ## ######  # ## # ## ##  ### ####    #   #
#          #####     ## # ##### #     ###### ## ##### ## ##  ####  ##     ### ###### # #### ## #        ## # # #   ##  ## ###  ##    ## ## # ##  ## ###    ## ### ###
########## ## ## # ######    ####### ## ##    #       #  ###    ## #  ###            #  ##  #### # ## # ## # # # # #  ##    ## ## # ##   ###  ####    # # #######   #
## # ##    #     ###      ##  ### #   #  ## # #### ## # ## ####      ##   # ##### # ###  ##  ##  ###### ## ########## ## # ##   #############  ##  # ## #       ## ##
#  # #  # ## # ####### # #### #   ### ## #  #  #    # ###       ## # #  # ##### # # #   ##  ####    #####   # # # #   ## ######  # # # # #  ## ## ##  ###############
##     ## ## # #       # ##   ###   #      ###   ## ###   ### ###  ### ## ##      ##### #####    # ## #### ##       ###   ## ##### # # #   ###### ## ### ##         #
#  # # ## #### ## ### ##  #####   #   # ## ##  # ## ##  #  ####### ### ##### ## # ##     ##   ## #    # #  ## ## ## ### #  # #           #   ## # ##        ## ## # #
## # ###    #######   ## ##   ###### ## #  ##### ######### # #   # #   #     ## # ## ## ##  #  ### ##   ## ##########   ##     ## # # # ####  # #### # # ##  #  # ###
## #  ## # ##       # #   ## ## ##   ## #### ##  #    ######   #   # ####### ## # #  ##  ## # ###  ## # ##  ### ## #  # ## ### #### ###   ###    # ##################
#  ##  ###  ## ## # #######        #  ###     #######   # ### ### ##### ## # ## # ## #  ##  # ##  ##  ##### #   ## ## # ##  ##    #   ## ##   ##             ###    #
## #  ##   ###### #####     ############### #     # ### #     #   ##         #### ## ##  ## #  ##  ##    ###### #     ###  ##  ###### ##  ### #### ## ### ##     ####
## ##  ## ##      ### ########   ###  #  ##### ##         ## ####  #### ## #   ## #  ## ##  # ### ########        # #  ### ###     ########     ##  #   #  # ###### #
#   #######  # ## #    ##### ### # ## ## #     #  # ### #  ###    ##    ##### ##  ## #   #### #          ####### ## # ##     ## # ## ## ##### #### ## ######        #
## ##### ############ ##   # ###       # ######## ##### ## ##  ##  ####  ##   ###  #### ##    # ## # ## ##        # # #  # #  ### ##  #     #    # ##      ## #######
#  ##         # #   #  ###   # ####### #          ##    ## ######### ### #  #  ## ##     # # ## #  ###  ######### ### ## # ##   #  # ## ## #########  ### ##        #
# ###### ## #   ###   ## ### # ##        ## # # #  ## #  ###          ####### ##   ## ## # # #  ##  ### # #       #####  # ## # ##       ### # ## ###  ###### ## # ##
###### # ######     #           #### # # #  ### ##  ### ###### #### #          ## ##  #  # # ## ###   # #   # # #    ## ##  # ###### # #  #  # #    ##   # ####### ##
## ##  ### # ##### ## ## # # ##      ########   ## ##   ## ##  ##   ####### # ##   ## # #### #### ## ######## #### #### ## ##      # # ##   ##   # ##  #    ##   #  #
#   ##  #          ## #  # # #### # ##    ##### #  #  #  # #  ### ###       #  ## ### # #     ###     ##       ##   ##  ## #  ## #####  # #    # ##### # ##    #### #
# #  ## ###### # # ##### ### #    # ### #       # ### ## #   ##     ### # # # ### # ###### #### #### ##  ## # ##  # ### ## # ##  ## ## ## ## ###   # ###  # ## #  ###
# ## ## # # ######  ##   ######## # # #### # # ##  ##  # ### ########   # # # ##    ## # #### # #    ## ### #  ####   # ## #  ##    ##  #  ###   #    ## ####### ####
###                #### ##  ##    # # #    #####  ##  ####   #        # # # # ## ## ##    #       ## #  ##  # ##    ### ######## ####  ######### ### ##      ###    #
#   # # ## # # # # #  #####    ## ### ### ### #  ### ##    ##### ## # # # # #### #  ## ##   # ## ##  # #### #  ## #   ### ##        ##       ###   #  ### ##     ####
### ###  ### # # # ##     # # ##  #       ##    ##   ### ####    ## # # # # #    ##  #### # ###  ### # ##   ## #  # #  #  #### # # ##  # ###   # ######    # # #   ##
#   #   ###  ############   # #  ######## ## ##  ## ## # #    # ##  # ######### #### ##   #   ##  ## # #### #### ## ##   ##    # #### ## ##  ###    # ### ## # # #  #
##### # # ## #  ####      # ###########   #   ## #     ###### # #  ## #    # #  ##   ### ### ##  ##  ###    #    #  #### ## ## #    ###   ##  #######   #  ##### ## #
###   ### #####  # ##### ###### # #     # # # ## ## ## #      # ## ####### # ##  ## ## #  ## ### ######  # ### # ##    # ## ## # ##   ## ####         ####### ####  #
#   ###    ## ##     ##### ## # # ### # # # # #  ##  ### #### # ##   # #     ## ##  #    ##   ##  ##    ##   ### #  ## # ## ## # ## ######### ## ## # ## #      ### #
########## ##  ### #                  # # ### ## #########    # #  ### ##### #   # ### #  ## ##  ##  # #### ##   # ### # #  ####  #  # ## ##   #  # #      # ####   #
#      # # ### ######## ### ### # ## ## #   ######     ##### ## ####           # # ##  ## ## ## #### # #    #  # # ##  # # ##    ###       ##### ## # ### ##   #### #
#### #                  ##  ##  #  ###### ##### #  # #       ## #    # # # # # # # #  ### ## ##   #### ## # ## # #  ## # ###### ## # ## # #### #  # #   #  # #   ## #
#  ##### # #### ####### ### #  ### ##     #       ###### ## ##  # ## ### ### ### # ## #    # ## ### #   ###### # ##  ####### ##    # ## #      # ##### ### # # #  # #
##  # #  ####   #       #   # ###   ## # ### # ## # #    ## ## ## ## ######  ##  # ## # # ## ## ##    # #      # ### ##         # ########### #### # ### ### # ## ###
###     ##  ## ## ## ## ### #   ## ##  # #   #  ###   ##  # #  #  #  # ## ## ## ####### # ## ####  # ## # # # ##   ###  # # # ###  ## ## ####             #### ##   #
# ##### ###     ###  #   ## ## ##  ## ## ### ####   # ## ##### ## ## #       ## # # ##  # ##  ######### # # # #  #  ### # # #   ##          # # # # # ###    # #  # #
# #       ##### ##  ######  ####  ############# # # # #   ##   ####  ### # # #       ## #####   ##      ####### ###  ## # # ## ##  ## # # # # # #####  ####### # ####
#   # ## ##      # #####   ##    ##    ###    #   # ##### #  #  ######   # # ## # # ##   ##   #  ## # #  # ##    ## ##  # #### ###  # # # ########  ##       # ######
# ### #  ## # # #### #   ###### ######     ##   # ####    ####### #    # ######## ##### ##### # ########    ### ##  ### ###     ### # # #     ## # ###### ####### # #
####  ## ## ###  ##    #      ###    ## # ##### # #    # #### #     # ## ##         ##    ### #  ##  # ## ####   ####     ## ## # ##### ## ##      #    #  ## #     #
## ## ## ####   #### # ## # # #   ##    ### ##  # ### #####     ## ##  ########## ###  ####   # ####      #    #   ## # ######        ###  ## ## #   #######    # # #
#     #   #####   #### ## ####### #######      ## #   #     # # #  #  ##            ##   ## ### # #  # ##### # ## ##  # ## #   ## ###   ## ## #### #  ## # # #### # #
## ## ## ##     ###    #    ##    #     ######  # ### ### # ### #### ########## # # ## #  # ##  #   ## #     ###   ## # #    # ##  ######   # #    ##          ## ###
##### ## ## ### #   ## # ############# ### #   ###### ##  ###   #    ##         # ###  # ## ### # # #### # # ##  #  # #### # # ###      ## ##### #  # ## # # # ##  ##
# #   ## #  #   ## ##  #   ## # ## #         #  ### #  ## #   # ## # ## ###### ##  ## ####   ## # ###    # #  # ## ##   ## # # #   ## ###   ###  ## # ## # #######  #
#   # ## ## # # #  ## ## ###    #    # ## # ## ##     ####### # ## # #  ###     ##  #    ## ##  #   # ## # #######  ## ##  # # ###  #   ## ## ####  # ## #   ## ## ##
### #  ###### # ##  ####   #### # ## # #  # ##  ### # #  #### #  ###### # #### ##  ## ####  ## ## ###### #   ##    ##   ## # # #   ### ##        ## #  #####    ##  #
#   # ### ### #  ## ##   # ##      # # ## #  ## ##  # ##  #   #####   ###       # ##     ## #  #  ## #   # # ## # ### # ## # # ## ###   ######## #  # ###### ####  ##
## ## ##      #######  # ###  ## # # # #### ##   ########   # ##    #     ## # ####### #  # ##### ## ### ### #### # # #### ###### # ###      ###### #    # #   ###  #
#   # ### ######## ########  ##  # # # #     ######  ##   ###  # ## ## # ##  #       ### ######   ##       ###      # ###  #         #### ##    ##  # ##   ##### ####
# # # # ####                ##  ## ###### # ##    ##    #  ## ##  ###  # ### ## ### ##     ##   ######### ####### ###   # #### ## ##   ##  # # #### #  # #          #
# # ###      # # # # ##### ##  ##      #### ## ##  ## # ## ##  # ##### # #   #   ##  ## # ##### ##           ####   ### # #    #  ## # #  #### # ## ## # ####### ####
### ##  ### ## ### ###   #  ###### ##### #  ##  ##    #### #  #####    #### ### ### ##### #     ## # # ## ####    #   ### # #### ##### ##   ##   ## ####       # ####
#   ####### ####   ##  #   ##        ##    #### ##### #    ## ##    # ### ###     #### ## ## ## #  ### #   ##### ## #   # # #      ##   ## #### ##  # ## # #####    #
##### ###      ###  ######  ### ## ##### #    ###     # ##### #### ## ##      # #  #    ######  ## #   ## ## # ###### ### # # # # #### ##   ##  ###    ### # # ######
#         ## # #   ###     ##   ## #     # ## #   # ### #       ####   # # # ## ## # #####     ###### ##         # ##   ######### ##    # #  ## # # ##  ##      ##  #
# ####### ####### ##   # #  ### ## # # # # ## # # ####  ## ## ###    # ### ###  ##       ## ## ##     #  ## ## #   ## ###  # #    ### # ####### #    # ##  # ##### ##
# #          ## ###  # ######    # ### # #  #######    ##  ###### #### ###  ## #### # # ##  ## ### # ### ## ## # # ##   ## #   ##   # # ## ##   ## # ##### #        #
# ### # # # ##   ## ####      # ## ##  # ## ##      # ####  ##    ##   #   ##   ##  # #######  # ##### # ## ## # #  # #### # ##### ####     # # ## #   ##  # # ## # #
# #   ##### #  #     ### ## # ########## ##  ## #####  ##  #### #  # # # # #### ### #       ## #  #       # ## ### ##  ##       ##   ## # ### # #  ## #### ###  ### #
# # # ##    ## ## # ##   #  #    ##       # ##  #     ##  ##    ## # # # #  ##   ## ## ## # #  ##   # # # # ## ##   # #### # # #### ##  #   # # ## ##  ##    ##  ## #
################################################################################################################################################################### #
