#.###################################################################################################################################################################
#.##    #   ##     ## #  # #            ####        # # #         ## # #          # ##     #### # #  # # ## ##     #  # ## ## # # ####  # # ##  ##      ## #        #
#..####   ###  ### #    ## ### ########  ##  ###### # # ### # ## ###   ########## # ######  ##  #   ##       ##### # ##  # ##      ##  ##    # ##  ## ####   ## # ###
##.## ###   ###### ## ####  #####   ####  ####      # #  ######    ## #### ## #      # #   #### # ######## ###       ## ##  ### ###### ##### #  ## ####  ### ###### #
##.#   ### ## ##   ## ## ##  ## ### #  ## # ####### # # ## #  ## ###  ## # #  #### #   ## ###      # ## ##  ######## #  ## ## # # ## #  ##     ##    #  #### # # ## #
#..#*### # ## #### ## #  ## ##  ##  ##    # # ## #    # ##   ##    # ### # # ## #  ###      ### ##    # #  ##        # ##  ## #    # # #### ###### ### ##  #      # #
##..,,,,,# ##  # # ## # ##  #  ##  #### #      # #### # ####  #### # ##         ## #   #### # # ####### ##  ######## # ### #  # ####     ##  ## ## # #  ##   ###### #
#  # ###,,, ## #   ## #  ## ##  ## ## #### ###   # #     # ## ##   # ### ## ###  # ### ##   # #  ## # # ## ## # # ## # # # # ##    #### ####  #        #####    ##  #
# ####   #,##  ### ##   ##  ###  # ## ## ##### #   ##### # ##  # #    ## ###### ## ########   # ##  #   #  ## # # #    #   # ## ## # #   # ## # ######### ## ###### #
#  #######,### ##   ###  ##  ### # ##  # ##  ##### ### #    ## ##### ##### #  # #### ###    #    ## # ### ##    # #### ## ## #  #### ## ## #       # ###  ## #  ##  #
#### ## # ,,,,,,## ##   ##  ##      ##    ## ## ## # # ### ##   ## # ## #  ## #  ##  # ####### #### # #   ##### # ## # #   #   ## #  ## ## ### #####   ## ## # ##  ##
#    ## ## ## #,,,,,### ### #  ####  #### ## #     #   # # ####       # ##    # #### # ###     # #    # ### ##    ## # ## ## ###    ##  #       ## # ###   # #    ###
#### #  ####### # #,#    ## ####  ## #  # ## ##### ###      ######### # #####    ##  # # ##### # # ####  ## #  ##              ### #### ## ####### # # ###     #### #
# ## ## # ## ######,#### #   #### ## ##   ## # #     ##### ## ##  #           ###### #   # # #     # ## ##  ######## ## ### #### #  # # ##    ## # #     # ######   #
# #             ###,# ## ### #  ,,,,,,## ##      # #        #  ## ########### ##  ## ### # # ### ### ##  ##  ## #  ###### #      # ## # #  ##### # # ##### ####   ###
#   ## ####### ##  ,,,##,,,# ###,####,,,,### ### ##########   ###  # #         ## #           #   ## ## #### #  ## ## ##    ###### ## # # ###  # #      #       #####
## ##  #        ### #,,,,#,,,,,,,#######,  #######     # ## ### ## # #########  # ########### ## ##  ## # ## # ##  #   # ##### # # ## #   # # ## # ###### ## # ##   #
#   ## ## #####     #### # ## # ##      ,##### #######      # # ## # ## ##     ## # ##  ##        # ###   ## #  ## # #    #      # #  # ### # ##    ## #   ######## #
# # ##  ####    ## ####### ########### #,,## # # # ######## #    # # ##  ### # ##    ##  ######## # #   # ## # ##  #### # # ###### ## #  ##   ## ####    #  # # #   #
# # #  ##    # ### #    ####    ## ######,,,,,,,,# # ##,,,,,####,,,#  # ## ###  #### ## ## #          # ###    ## ### ###   ## ##       ### ####  ### # ###   # # ###
##### ###### # #   # ##   #### ##    ## # # ## #,,,,,,,,# #,,,,,,#,,,##  #  #  ## ## ## ## ######## # ######## ## ##   ## ###  ####### ###   ##  ## # ### #####   # #
####### ## ##############      ##### #  ########### # ### ## # # ###,,## ##   ##     ## ## ## ##### #  ## # ## ##  ### #    ## # #  ## ##  #  ## ## #   #  #    #   #
# # ##        ##    ########## #  ## ## ## ## #  #  ###   #  ### ####,,,,,## ####### ##  # #        ##### # #   ## ##  ## #### # ##    ## #####       ### ## ########
#   ###### ##    ##  ##   #### # ##  ## ## ## ## ## ### # # ##   #  ## ##,,# # #        ## ## ##### ##  # # ### ## #  ##   ##    #####  # # # ## ####  #   #   # #  #
### #      #  # #### #  #         ##       ##     # # # ########### ######,,,, # # ### ###  # #   #  ## # # # # ##   #####  ### ##   ## # # #       ##   ### ### # ##
# # #### #### ### #    ## # # # #    #### ###### #### ###### #  #    ## #  ##,######   # ## #####   ##  # # # # #  # # # # ##    ## ##    #   ## ##### #       #    #
# # ####### ###     ## #  # ###### #####   ## ## # #   ## #  ## ####  #   ## ,,,# #### # #   # ### #### # #     ## ### # # #### ##  ### ### ###      # # # # #   ####
# # #  ## # #   ## ######## ## # # #     #  #  #   ### ## ## ##  ####   # ### #,,,,,,,,,,# ### # #  ##  # ##### #  ### #     ##  ##   #     ##### ########## ## ### #
# # # ##  # # #### # ##  ## #    ### ###### ## # ##### ## #  ### #  ## ##  ## ##########,,,# # # # ####   # #     ## # ### #### ##### ## #### # #### ####  # #      #
#        ## ####   #  ##  ######  ######       # # #    # ##  #  # #######  ### ###      #,,,,,,,,,##   ### #####  # #  #   ##   # #  #          #   # #  ##### # ###
### # ## #   # ##### #### ## ##  ## #  #######   # ####   ### ##    # ########      # # #### ### #,,### ##  # #   ## ## ### #### # ## # ########## ### # ## # ###   #
#   ###    #                 ### #  ##  ###### # # #  # ###      ##    ##### ## ##### # #    ##  ##,# #  ## # ## ##  #   #   ##    ## #                         # # #
# # #   # ## ### ## # ## ### # # ## ## ##      #   ## # # #### #######  ##      ## ################,,,,,##    #   ## ### # #######  # # ######### ############# # # #
####### # ## ##   #####  ##    #       ## ## # ###      # #### #       ##########    # # # ## ### #####,,#### # ###   ##      #  ## # # #     ### ####       #### # #
#       # #   ## ##     ##  ##   ## ##  ########## # ##      #########   # #  ##  # ##   # ## #    ## ##,,##    ##  ###  # #### ##        # # # #      ## ##    # ###
###### ##### #####  # ###  ##### #   ## ## ##### #####  #### ## ## ##### # ## #####  ### # #  #### #   ##,,####  ## ##  ## ## # ## # ### ###### #### # ##  # # ######
###     ##   ###### # #   ##     #####     # # #  # #######      #    #  # ##  ##   ##   # ##   ##   #####,,  ##  # ## ######   #### ##### # #  #### #  ## ###   ## #
# ##########  ## ############## #####  # #       ##       ###### #### ## # #  ##### #### # #### #  # # # ##,###  ## ##    ##  ### #            ##  ################ #
# # ###  ### ##     ### #       ##    ## ## # # ######### # ##   #         ##  ## #  ##           ##       ,,,##  #  # ####  ###    ## #########  ### # #     ####  #
#     ## # # ##### ##     ### ###  # ##  ###### # ###   #    ### #### # # ### ##  ## ## ## ### ##############,#  ## ## # ### # ## ###   # ## ##  ##       #####    ##
### #    # ### #      ################# ## #    # # ### ### ##     #### #  #   ## ##  ######## ### ####     #,# ### #  #  #         ###         #### ###### # # #####
#   ## #    ## # # ## ##         ##     #    ##              ### ### ##### ### #   ## ### ## # #      #####  ,, # # # ## ## ### # #   # ##### #### #             #  #
###  ######  # # #### #  ###### ##  ### ########## ######## ## # # # # # # ##    #         # ########       ##,## #          ## #######   ###### # # ##### ### #   ##
# ## ## #### # #### #### #         ######          ##                      ##### ## # #### # ##     #### # ## ,,#   # # ## #  ####    # #    #        # ##########  #
# ####          ##  ## ######## # ##      # ##### #### ######## # # ### ##   ##  ## # #      ###### #### ######,,,### #  # ##  ##  ####### #   ### ##         #  ## #
# # #  ########  ## ## ### ############ ### #      ##  #        # ###    ###    ##  # #### #  # #   #  #### #   #, ## ########    ## #  ## # # ###### ###### ## #####
# #   ##      ## ## #            ## ###   ##### ##  ## ###### # ##########   ## ## ####### ## # ### ##  ##    # #,##      #### ##    # #########    #    ######     #
#   # ### # #         # ###### #    #   #### #   #######      # ##  # #    # ##  ### #     #    ### ###  #### # #, ## # #  ##   ## #       ## ### #### #      ## ####
# # #  ######### # ######      ## #   # ##     ###    #  ## # #####     ## # #  ##   ##########         ##    # #,### # # ##  # #### # # #     #    ##### #####     #
