# ###################################################################################################################################################################
# # # ## #  ##    #   ## #      ## #   ## #   #  ## # # ## # # # #    # ## # ##          # ##  #       #  # # ##  ## # # # # # # ## # # ##    ##  # ## ## # ## #    #
#   #  # # ##  ##   ###  ######    ###    ## ## ##         # #     # ## #  # #  # ######## ###   ### #   ##    # ###     # # #   ##        ##  ##    # #  #  #   # ##
### # ## #  ####### #### ###    # ##### #     # ##### # # ## # ######## ## # # #####   #    #  ####### ###  #### # ## # ##     ###  ## # #  ###### #   ## # ## ######
# #   ## # #####  # # #    ######  # ######## # #  ######         # # # ##       # # ### #### ###    ##### ##  # # ## #### ######  ##  ####  # #   #####          # #
#   ###  # #   ##   # #### # ##### # # # #    # # ## # #  ######### # # #  ### ### # # #   ## # # ######    # ## #     # # #  ##  ### ### ##     #  ##   # ### ##   #
### # ## # ###    # # # #          # # # #### # # #  # # ## ### # # # # ##   ##### # #   # ## #     ## ## ### ##   ###       ##  ## ####   ####### #### ##  ##  ### #
# # #    # ######## # # ## #### ##   # #  ##  #   ##     ## # #   # #   ## ###   # # # #####    #####  #         #   #### ##    ##   # # #### ######    #####  #### #
# # ## ### # ## ##       # ######## ## ## ### # #  ## # ##  #   ###   #### # ## ## # # ## #### ###  ##   # # ##### #    #### ####  #              #####  #####  # ###
# # ## ##  # #     # ### ###   ## #  # ## #     ####### ###   # #   ###         ## #       ##  # ##    ####### ########    ####   ## # ## ### #####     ##   ##     #
#       # ## ## # ###### ### #  # ##   #  #####  ## ##   ## ##### ######## #######   # # #  ## # ## #### ## ##        ## #    # #### #  ### ###  ##### ##  # ## #####
### # #      ###### #    # ####      #   ## # ## #   ### #    ##      # #     #  ## #########                  ##### ### ## #   ## ####  ##  ###  ## # #  ## ##   # #
#   # #### #   # ## ####    # ##########  # # #  # ###     # ##  ###### # ## ## ##      # ##  # ## # # ### # #     #   ########     # ## #  ##   ### #   #####  ### #
### # #    # #           ##       #### ##   # ##   # ### ###### #### #  # ##### ## ###### #  #########   ### ## ########## # ### #### #### ##### ##    ### ######   #
##  # # # ################## #### #    #  #    ## ## ##     #    # # ## # # ##  ## # ## # # ## #     # # #####  ### ## # # #   ####    ### ## ## #  ##     # # ## ###
#  #### ### #      ###  ## #### # ####   ### #    ##  ## #### #### # ##      ##                  # #######   ##      #       #  ##  ##             ##### #      #   #
##  ##  #   # ## #   ##                ###   #### #  ###       # # #    # ####  ## # # ### ## # ## #       #  # ## ### ## ## ##    ##  ## ### # ########## ####   ###
###  ###### ########  # # # ## ### # # ##  #### # ## # ## ######   # ####### # #############  #  ### ################# ####  ## # #########   #     ##  ######## ####
# ## ###     #### ###   ########   # # ### #            #   # ## ### ### # #       ## #    ## ##  ## #   ## #  ## #       ## ####### ##  ## # ## ## ### # #    #### #
#    # #####  ##   #### #  # ### ### ###   ########### ## ### #              ## ####    #####  ##      ###  # ###   ########## # # # #  ### ###  #### # # # ##### # #
## ###    ### ####   #####       ##  #   # #              # # # ### # ## ## ###### # #### # # ##  # # ###  ## # # ###### # ##          ###    ##   #  #             #
#####  ##        # #   # ##### # #  ## # ######## #### ####       # ####  #    #            #  ## # ### ##                 #  ### # # ## ## ###  ### ## ### # ## ## #
# # ## ### ## ## #### ##       #### ######  #     #     #   ########## # ## ##   # #### # ######  #        ###### ###### #   ##   # #     #   ## ##  ##   ######### #
# # ## # # #  #       ###### # #    # # ### ########## ## ###### # #   ######## ##  ##### ##   # ##### # #     ##      # ## ##### ##### ########  ##    #  # ##   # #
# #  ###   ## ## # ##  ## ## #### ###   #   #  ###                   # ###### #  ##    ##    # #    ## # # # #  # ## #####     ##     ###    # ##### # ###      #####
#   ##   # ########### ##  #########  # ### ## #   #### ### ############ ## # ####### ########## ######### # ## #  #    ################# #### ####  # # ### ########
### ###### #         # ###  ## # # #### #      # ####     #     #    ##   #   ####### ##     ###      #  ###  # # ## ##       #     ##  # #         ##     ### ## # #
#      ###### ######     ## ##     ###  # ## #   ## ### ### # #   ####  ### #    ## #    ##### ## ###   #### ## #  ##### # #### ###### ##   ###### ### # #  ##      #
# ### ## ## ###### #### ##  ######   ## ####### ##  # #   ########## ##     ####### ######  ## ###### ###  #  ####  #  ###### #  # # #    #      #   ######    ## ###
##### ##  #  #          ### # # #### ## ##  #    ##   # #### # ### # ## ###  #### # ### ## ### # ## # ### ## ### ##   ######  # ## #   # ## # #### #    # ### ##    #
#      ## ## #### # ###         #    #   ## #########                   ####    # # #       #       #     #### # ####### # ##        # #  # ###### # ##     #########
#### #         ############# ## #### ###       ## ##### #### # ## ## ##    # ## #     # ###   # ## ### ##  ##     ## # # # ## ##### #### #####   # #  # # #      ## #
##   # ####### # #     ###   ##          #####  # #      #####  # ####### ######## ######## ################## ####  # #          #  ##    # # ##### #### #### ###  #
#  # ###       # ### #     #  ## # # ## ##   ##     ## #    ### ### # ##### ## #      ##  #    ##  ## ## #  #     ##     # # # ######## ##      # ## #  #   #####  ##
# ## #   ##### # # ############  # #  ######    # #### # ##  ##       #          # ####  #######  ##   # # ## ## ### ## #### ##### ## ##### ## ##  #   ###### # # ###
# ## # # #          #           ## ## #      # ####    #  ##  # # # #   ## # ## ##      ## # #### ## ###   ## ####   ## # ##  ## #     # #   ###  ## ### ##   # # # #
# #  # #### ## # ##   # # # # # ######## # # ######## ## ##  #### ### #  # #  ##### #####  #   #   # # ## ##    #  ####    ####    # #   # #     ##   ##  # ###     #
# ## #### ########### ##### # #  ## #    ###### #      #  ##   ##   # # ######### #       ## ### ###    #  # #### ### # ##### ## ##### ###### ## ######## #   # #####
# #  ##   #     #         ### # ##    ##  ##    ## # ### ### #### ##### #  ## # # ## # # ##    # ### #### ## #### #   #              #### # ###   ##        #   #   #
######### #####   ## ##########  #### ### ## ##  # # #     #  # #### #### ##       ### #    ##                      ### # ## ### ###### # # ### #  ## ##### # #   # #
#  #         #### #  ## # # #######   # ###   ##   # # ## #####  #   # #     ### ######## # ## # # ## # # # # # # ### # ###  ##   ### # #     ####        ### ## ####
## ######### # #######      #  ##   # #     #  ## ## #### # # # ## ### # # #   ####    ## #  ### # ## # ##### # #     ###########         ###  # ### # # ##   ##  ###
#                # ##  #### ## ################## #  #               # # ### # ##   ##  ### ######  ###     ##### # #  #       ## # # ###   ##     # # ##### ####   #
########### # ## #    ####     # ##          ###  ## # ## # ### # # ##    ## #    #  ## ###      ##  ## ### ##########   ## ##  #####   ###  # ### ###### ##    ## ##
#        #### #    ## ##   ### # #  # ## ###   ####  ###  # ### # #    ##### # ## # ###   # ## #######  ##### # ## # # ########### ## ###########          ## # ##  #
### #### # #  ## # #   ## ###      ######### # #### ##### #   # ######   # ###  # # ##  # #  #       ##    #       # #     ## #     # ##      ##  ## ########## ## ##
#####        ### # ## ######  # # ## ## ## ### #  ###     # # #    ##  #    ## ####  # ## # ######## ## ##   #####   ## ##### # ######## ####  ####    #####  # #   #
# ########## ##  # #  ##     ######         ## ## ##  # # # # # ####  ## # ##### #######  #        # #  ## #     ######    #    #### # # # ###    ######     ##### ##
# #          ### # ######## ## # ######### ##        ## # # ###    ##  # ### ###   # ###### ## # ### ## ## # # #      ###### ####            ## ### ##   ##### # ####
#   ## # # #  ######    #####       #         ## # #  # ###   ## ###  ##         # #   #  #### #  ####   # # # ## # #             ## # # # ######      #            #
# # #  # # # ## # ##### # ##### # #   ## #### #  # ## ###   #  #   ## ## # ######### ### ### ####    ## ## #####  # # ###### # # ##### ##### #    # # ######## ### ##
# #### # # # #      ##          #### #####    ## # #    ### #### #  #### ####  ## ## # #     ## ############# ### # #  ##### # #     #     # # #### #        # ######
###### # ### # ## #  ### # ######    #     # ##  ### # ## #  ##  ## ## #      ### #      # #        #   #   # # ######     # # # ### # # #        ##### ######      #
### #  ###   # #  ##     ############# # # # ### ##  # #    #### #     ## # #       # #### ## # ##### ### ### # ## # ### ##### # ####### # # # ##### #       ## # ###
#     ##   ### ## ##### ##             # # ### #### ##### # ###### ## ### ### ## ## #    #  ####### #                  #     # #    #  ### # #       ############   #
### #### #   ######     ## # #### ## # # # ##   #   ##    #  ##     # ##    ####### ## ####  ##       ######### #### # # # ###### ### #### # # #######   ## # ##### #
#      #######      ## ########## #  # ######## ### ## # ## #### ## ##### #####   # ##    ##  ## #### ## ###  #   ########     ##        # # #   ## ## #         ####
### ####     ########### ###      ## #   ### #   ## #  # ##   ####    ##  # #   #####  ######      ####      ## #   # # #  ######### ## ########       # # ## # ## ##
###    ## ##  # # ## ### # ### ## ## # # #     #    ## #  # #   ## ######     #     ##     ## # ##   ## ############# # ##   ## #### #### # # ### ###############   #
#   # ##   ##        #   # # # #   ### ### ## ### ###  # ## # # ##     ## ######## ##  # #### #  # ###                  ######     #   #       ##     # # #   ##  ###
# # ##### ###### ###   #       ## ##   ##  #####  #### #  #######  ###  #        ##### #    ######  #  # ### # # # ## #      # ## ## ### ######## # #       ##### ###
###  ## ### #    #   # ## # ## ## #### ## ##   ##   ## # ###  ####   ##### ##### ##  # # ##### ###### ########## ######## ##    #  #            # # # ## #### # #   #
#   ##   ## ###### # #  ###### ##  ###  ###### #  # ## #     ##    #  ##     #####  ####   # #   ##    ##     ##    ## ###### ###### ## ## ## # # # #  #### # #   ###
# #  # #      ##   #######      ####   ##        ##  ### # ###  ## ####  # #    #  ##### #     #    ##    # ##### # #      #####  ## ##  #  ##########        # #   #
### ## ## # #    ####    ## # # ###  ########## ##  ##   ###### ## ####### # ##   ## # ### # ##### #### # #   # ##### ###### #   ###### ######    ##   #### #   #####
#   ## #  # ## # #  ####    # ###   ###     # # ## ##### ##     ##      ## # ## # ## # ### #    ##    # #####    # #    #      ### ## ### ## # ####  #    # ## ######
# # ##### # ####### #    ## # ##  # #   # #     ##  # #   # ## #### ######## #  #      # ######  # # ##    ### #     ##   ### ##        #       # #### # ####       #
##### # ##### # # #   ## #  #  ## # # ### #### ### ## ## ## ## ##      # ##  ## ### ##     #### ## #######   # # # # ## #   #### ######## #####   # ## #    ## # # ##
#  ##      #      # #### # ## ##  ####### ##   #       # ## ## ##### #   ## ##    # ## #####  # ##  ## ### ####### # ########  #  ## # ##     ## ## ##### ###  # ####
## #  ####   # ##   #    #############    #### ### ### # ## ##   ##  ######  ### ## #   ###  ######      #       ###   #   ###   ###    # ########     ##   # ##    #
#    ##    ####### ### #    ### ### #  ## # #####   ## #### #  # ###      # ##   ##### ## # ## # #### ## #######  ### ## ###   # # ####    ## # ## ## ##  # #  #### #
# ## ######## ##   #   # ####         #####     ## ##  ## #### # #   ## # # ## #   ##             ######       #### #     ### ##   ## # ## #       ########## ##  ###
# #   ##      #### ######## # ####### ##    # #    ###      ## # # # ######### # ###  ### # # # #      # ### #  # # ### #      ######    #   # ##### ## ## ######   #
#### ##### ## # ####          ## # #   ######### #   ## ######## # # # # #   ###   ## #   ##### ## # ###   # ##       # ## ## #### #  # ## #####      #     ## #  ###
#     ##   #      #  #### ## ##  #   # ##        ## ###    ##    ###       ####  ###  # #    ##  ######### #  ## ## ###### ##        #####     ## ##### #####  ## # #
#### ##  #### ###   ####  ##  ##   # #  ## # # # #  # ### ########   ## # ### ##   ## # ## #####    #   ######## ##      # ### #### ## ##  # ####  ## #   ##  ##    #
#     # ### # ##  # #  ########## ## ##  ### # # ##   ########     #  # #  #   ### ## # #  # ###### # ### # ###  ## # ## #  ##    #     ## ####   ##    ###  #### ###
## # ####     ### #### # ## # # # ## ## ######## ## #      ##  # ### ## ##   ##### ## # ##    # ##            ########## ## ### # #######   # # ###  #### # ### # # #
#  #  ####### #   #               ## ####        #  # # ####  #####  ##  ## ## # ########  ##    ####### ###### #      ######   #      ### ##   ####  #     # #     #
##### #       ### #### # ##### ## #### ## ## # ### ####    ## # ##  ### #####          ## ### ##       #  # #   ## ####### #### # ######    # ### ###   # #     # # #
### ###########   ###  # #      ### #     ######    ##  ##  # #    ##         # ### # #####   ## ### # ##     ###           # # #    # ###### ##   ## ####### #######
#    ## # ###### ##   ## ## # #  ##   ### # ###### ####  # ## ## #  ### ## ####   ###     ## ##    ####### ##     ## # ######   # ##    # # #    #  #       #       #
## #          ## #  # ## #######  ### ##  #  # #    ##  #######  ## #    #    # #   ## # ##   ## #### ## ##### ######### # ### ## ### #       #####   ## ###### #####
###### # ## #  #### ###### # ##  ###  ## ###     # ####       ## #  ### ## ## # ## ##  #  ### ##             #      # #      ###   ## # ## ## ### ## ###    ###### ##
#   #  #  ####  # #    ##       ##   ##   ##### ##    ## # # ###### #    ###  ###   #####   ###  ##### ## ## # # ##     # ##   ###### # ##  #      #   ###### ## #  #
# #   #########     ####  #### ##### ## ###      ## #### ###### ##  ## #   ##   # #   ##  #  ###     ########### #### ###### #    ##  #  ## # ########         # # ##
# # #  #### #   #####    ##    #     #  ##  ### ##   ##       #  ##### ## ############### # ##   ## #### #    ##    #  # # # # # ##  ## ##  #        # # # ###   #  #
### ## #      # #     ## #  # #### # ##  ## ### #  #  ## ## ### ## ##  #         # ####   # ## #  #    #   ## #  # ###     ### #  ##  ##### # ############   # #   ##
#   ############# ### ##### ### #  #  ##  ###   # ## ### ##  ## ## ## ## ## ####      ## ## #  # ## # ## ###  # ##  ## ####### # ### #### # #         ##### ## # #  #
## ##       ##### #    ##   #     ## ##  ##   # # #    #  # ##         # #   ##### # ### #### ## ## ###  ### ##### ##   ###  ######   # # # #### ## #  # ## #  # # ##
#  ######## # #   ######### ## # ##   ## ## # # # ## #### #  ## # ## # # ### # ########   ##  ## ##  ## ## ####  ###  #     ### # ##### #      #  ####   #### ## ####
#### # #  #     # #         ## ###  #### ## #######     # # ##  # ## ######           # # ## ###  ##  # #   # ## ###### #####      #### #### ########  #    ####    #
# #  # ##   ## ############ #   ###  ##  ## ## # ### ###### ##### #   ##    # # #########  #   ##  ##     ###         # ### ### ####  #   ##    ### ## # #####   ####
# ##      #  ### ## ######  # #   ## ### ## #     #      ##   ### # ####### ###    #    # ## ###  ### # #     ## ## ### #    ## #####   ##### ### #  ###     # #   ##
#    ## # # ##             ##### ##### # ## ## ##   # ##  ## ##   #    ##    ## ##   ## ####   ##   # # ## ## ####   #### ##       #  #     #       ##   ####### #  #
### ##### ######## ##### #  ##   ##       ######## ##  # ####### ### #  ## #  #  # #  #    ## ##  # # # ## ##    ###  ##   # # # ### ### ##### # #######       # # ##
#   #     #      # #     # #####  ### # # #        ## ##   ##     ## ## #  # ### # # #### #####  ## # # ## ### #   ##    #######       #    ####     ### ### ##### ##
# # # # #### # #   ##### # # ##  ##   # #### # ###  # ### ##  ## #####  ## #   ### #   #### #   ### # # ##   # # # ## ##    # ##### # #####    # # #   #   #   ##   #
# # # # #    ### # #     #    ## ## ### ##   ###   ##   ##### #    #### #  # # ### ## ## #  ###   ### # ## ### # ###  ## ##     ####### #### ##### # # # # ## #### ##
# ########## ######### # ## ###   ###    ### #   # ## #    ## ## #   ## # ####   ###       ##   ###   #### #####   # ##  ## ##### ## #     #    #### ##### ## # #  ##
#### # # ##  #         # ##   ## #### # ##   ##### ## ## #  # #  ## ##  # ##   #   ## ## ###  #  ### ###      ## ###  ## ##   ##       ## ### # #  #  # ####    ##  #
#         ########## # ##### ##  ##   #  ### #      # ## # ## ## ##  ## #  ## ## # ## ####### ##  ##   # ## # ##  ## ########    ## # #########   ###      ######## #
#### ## # # ####  ####   ##  ## ##### # #### ##### ## ## ###  ## ## ##### ##   ### #       ## #  ##  # # ## #  # ##  # ### ## ############ # ### ##   # ##        ###
####### #    # ## # #  # ## ######    # ##   ##    ## ##   ## ## ##   ##   ###   # # # ## ######  ## ### ## # ###### #   # #         # ##     #########  ### # ######
#     ### ##          ####    ##   # ##  ## ##### ##  ## ###  ## ## # ## #  ## #######  #  # #   ###   # ######  ##    #   ## ## # #    # # #   # #   ##  ## ####   #
### #      #### # # #  #### ###  # # #  ##  ##    ### ##   ## ## ## #### # ##     # #  ## ## ## ##   ##### # #  #### ##### ##  # # # ## # ####### # ###  ###### ### #
##### # # ##    ### ## #      ## ### # ######### ##    ## ##  ## #   # #####  # ###   ##  #      # #  # #      ## ##   ##  ## ## ### ##    # ##       ## # ###   #  #
#     ###  ## # #   ## # # # #####   # # # #     ## ## ##  # ##### #       ## #   ###  # ## # # #####     # # ##  ## # ## ### ##   ##### #      # ## ##### # ## ## ##
## ## #   ##  ### # #### # ###     # # #     # #  # ##  ## # # #   # # # #  #### ##   ####  # #  ## ## # ####    #######    # ## #     ### ###########  ## #    #   #
##  ######### #   #    ### ##  # # # ####### # # ## ## ##  #   ### # # ### ###    ### # ##### # ##  ## #   ## ##       ## ### #### ###  ##     # #  ###  # # ##   # #
#  ### # # #  ## ### ###    # ## # # ### #   # #  ####  ## # ###   # # #####   # ##      # #  #    ##### #  # ## ### ####   # #      # ##  ## ## # ## # ## # ########
## ##        ##  #     ## # # ## # ###     # # # ##    ##### ##  ### # # ####### #  # ##   ## # ## #   # ####  # ##  ## # ###### ## ###### ##    #  # # ##      ## ##
########### #### ## # ### # #### ###   # # # # #  # ##  ##    ##  ## #     # ##  ## # #### ## ###    ###########  ##    #   ##   ##  ### ##### # # ##    # ####     #
#### ###     # # #  # ##  # ##   ##  # # ### #### # ## #### ###  ##### # #    ## ## #  ###  #   ## #  # ##   ####### # ## # ### ####   #     ###      ##    # ### ###
## #   ## ##   #### # ## ## ## ###########     ## ###   ##  ##  ###    ### # #########   ## # #  # ##      #   ####  #  #####   ##   #   # ###   # # #### #     #   #
#    #    #  #### ### #   # ## #   ## # ### # ###  ####  ## #  ##   ##   ###         ## ### # # ## #  # # ## #    # ## ###### #  ## #### #  ## # ###### # ## # ## ###
# # ## ## ##  ##   ## ## ##  #####          #   # ##    ##  # ##  ###  #  ### ###### ##   # # ####### ###  # # # ## ##  # # #### ##   ##### ####    #   ###  ####   #
# # ## ##  ## ## #    ## ## ##     # ##### #### #  ### ##  ##  ##  ### ##  ##     ## #  #####  # #      # ## # # ##  ##      ##  ## #     ### #  ##   # ####  # ## ##
# # #  #  ##  ##### # ## ## ## # ### ###    ##  # ########  # ##  ##    ## ## # # ## ##    ###   # # ######  ###  # ### ####### ##  # ###  #  # #### ##   ###    ####
# #### # ####  ##   # #   # ######   #   ##  ## #     ##   ## ## ##### ###### # #### #  # ## ## ## #  ## ########## #         # ## ##   ##   ##   ## ## #   ### ### #
# #    #    ##  ## ##### ## #      # ###  # ##  # ## #####  #### # #     ##   #    # ## #     # #####     # ## ###### ## # ## #### #  #### #  # #### ## # ####      #
# # # ### ######## # #   ## # # ## ###   ##### ## #      ##    ### ### #  ## ### # # #  ### ##### #   ###         ###### ########  ##  # # ## #    # ## #    ## # ###
### #######     #  #   # ###### ########   ##   # # ### ##  ## ##      ####    # # # ##   #####     #  ## ## ## #   ##   ##   # # ### ## ###### # ####  ## #  # #  ##
#     ##    # #   ### ##  ## #### ##     #  ## ## ####  ###  #########    ## ##### # #  #     ######## ## ## ###### ## #    ### ###           # #   ## ### # #####  #
# # # ## ## ##### # # ## ### # ##  #### ## ###  # #    ##   ### #      # ##      ### ## # # #  ##   ## ## ##     ##  # # # ###    #### # ### ## ## ###   # #  ## ## #
# # # ## #  ##    #    ###        ###    # ##  ##### ###  ###     # # ##  ## # #  ## ## # # ##    ###  ##  ## ######## # #     ##  ##  # ######  #   # # ### ##     #
### ###### ###### # ######## # ##     # ##  # ## ##   ###   ## # ## #  # ##  # # ### ###### ## ##   ## ## ##     #   # # # ###  ## ## ##    # # ### ####  ##  ## # ##
### ########      # ##       ###  # # #  ## # #     #  ## ###### ## ## ####### # ##   ##     ##### #####   ## ##   # # # #   ##  # #  ### #   ### ### ## ######  #  #
# #   ##     # # ## #  # # ######## ### ### # ## ## ####   ## #  ## ## ## ##   #  ## #### ##   ##      ### ##  ## #### ### # ## #####   # ###   #  #   ####  ## ### #
#   #  ##### # # ############  #    ### # #####  ##   ## ###    ##  #      ## ## ######   #  # #### ########## ## #  # ##  #  # # ##  #####   ### ## #### # ##  ##  #
# # ## ##    ###  ## ## # # ##   # ##        ## ##  # ## ##  # ##  ### # #######      ### ## ###       # ###   ##   ######## ####  ##  # ####                ####  ##
# # ####  # ##   ##         ## # ###### ####  # ## ## ##  ####  #####  #    ##   # #####   #   ### # #     ### #  ### ##  ##      ####     ### # ## ## # ###    ##  #
# #  #### #  ## ###########    # ## ##     # ##  # ## ## ##    ##     ## ###### ##  # #  # # ###   # # # ########        #### # # # #  # #  ## #### ####   ### #### #
# # ##    # ##  #           # ####     # # ##### # ## ##  ## #  ## # ##      ##  ##   ## ###   ## ## ###      ##  ## # ### ## # #   ## # # ##   ##     ###   ### #  #
# # ## # ## ## ## ## # # # ## ##   # # # #     # # #   # ##  # ##  #  ## # #  # #### ##    ## ##  ## #   # # ##  ##  #     ## # # #  # # #  ## ##  ## ##   #     ## #
################################################################################################################################################################### #
