#.##############################################################################################################################
#...#.##..#.......#.#..#.##.#.#..##..#.#.#.#.#.#.#.#.##......##..#..##..#.##..##..#.##.#..##.##.##.#...#.##..#.#.#.#.##........#
# #....##...#.##.##.##...##...##..##...............#.#..########.##..##.#....##..##....#.##......#.##.##.#..##.#.#.#.#..########
#### #..########.##..#.#####.##..#######.###.##.##...##..#..#.#..###.##...######..##.#....#.######.#..##.#.##....#.#.##......#.#
#######.#.##.#....##.#.......###.##......#....######..##.#.##.##.#...#..###....#.######.#......###.##.#.....##.###....#.######.#
#.#..##....#...##....##.## #......####.#.##.#####.###.##.#..#.#..###.##..####.##..#..#####.#####.#.##.#.#.#..#.#.#.####.##.##..#
#.#.##  ##...# ### #.... # ### ##.#.#######.#.........##.#.##.##.#....##..##..#..##.##.#...##.#..#.##.#.######.#.#.##.#..#..##.#
#.#..###########   ## # #########.#.#.#.#.#########.#.......#.##.###.####..##...###.##.#.#..#...##..#.#.##.##....#.##.#.##.##..#
#.##......###.#########  ##.............#.##.##.....####.####.##.##..#.###.##.###.#.#..####...#####.#....#.#..####.##....#.##.##
#..#.####.#......###.##########.# # ###....#..####.####...##...#.##.##..#...#.##..#.##.##.##.###.##.#.####.##.###..#..#.##..#..#
##...####.######.#.#..##.##.....# ###   ##...##..#.##.##.#####...##..##.#.###..##.#.#..##.##...#.##.#..##..##.#.#.##.######...##
###.##.........#.#.##.##..#####.####  # ####.###.###......######..##.#........###.#.##.##..##.##.##.#.####.##.#....#.#.#.#..#..#
# #####.##.#.#......#....##..#####.###### ##......#..## #..#.###.##..###.#.#####.....#..##.##..#.#..#..#.#..#.#.####.....##.####
# ## ###########.##.####..##..#....#..###    ## #...######.......###.#...#####.#####.#.##..##.##...##.##...##....###.###.##..###
# #  # #  # # #####.###..####.####.#.##   ######### ##.##  ## ##.#.#.###..#..#.##.#.....##.#...##.##.....###..##.#.#...####.##.#
# ## # ##      ##.#.#.##.##....#.#....#######..##.###...## #####.#...#.#.##.##.##.##.####..###.#...#.#####.#####.....#..##...#.#
#    # ###### ##.......#..##.#...####...###.##....#####..# #.#.....#...#.....#.#..#...#.##.###...#.#.#.###..##.#.#########.###.#
# ##    ## #  #..##.##...#######......###....###.##.#.##.###.#########.####.##.##.#.#.#.##.#.#.#####.....##....#...##.#.#....#.#
###### ##  ## ##########..#.##.###.##..#####......#.#.....#....##...#..##....#.##.#.###..#.#...#.##..#########.#.####...#.####.#
#  #    ##         ## ###.#.##...#####.#.#.######.#.#####.####..###.##..####.#.##.#.####.#.##.##.##.##.#.#.#.#...##.##.##..#.#.#
## #### ########## ##*,,,,#.##.#####.#.......#......#.#........##....##.##.#.#..#.#.#.#....##............#.#.#.####.#...##.....#
#                  ######,,,##..##.#.###.###.######.#.########..####...........##.#.#.####....#.##.##.####.....##...#.###..#####
##### ## # #### ## # # ####,#..###.#.###.#...#.#......#.##.....###...#.#######.#..#.#.#..###.##########..###.#....#.#...##.....#
## ##########   #          ,,,##.#.#.#.#####...######.#..#####.#.#########..#..##...#.##.##....##....##.##...####.###.###..#####
#    # ## # ## ##### ### ## #,,,,,,#.#.##..##.##.####.##.#.##......##.#..##.##.##.#.#..#..##.#....#####.##.########...####.....#
## #   ##   ####     #   ## ## ###,,,,,###............#.......####.##.##..........###.##.##..###.##.#.............###.#.##.##.##
#  # #  ## ## ######### ##############,# #########.##...#.#######.....######.####..##..#..##..#####.###.#######.###...#.#...####
# #####        #    ###### ##       ##,  ##.....##.###########....#.#........#..##.###.#.###.##.##...##.##.##.###.###.#.#.######
####    # # ##   ##  # #    # ## ##   ,########..#.#.....#.....#.##.##.###.#.##......#...#.#.....##.##..#......##..##.......#.##
#    # #############   #### ####### ##,#.#.#..#.########.################..#####.# #...#.#.#.#####...#.##.#######.##..#.#####..#
########           ### ##    # ## ### ,#.#.##.#.#.##.....#.###..#.##.###..###.#..#####.###.#.##.####.#.#..#..###..##.##..#.##.##
##### ### # # # ##   #  #### # #   ###,,,,,,,,,,#.##.###.....##...##.#.##.#.....####....#.....#..##......##.##.##.....####.##..#
#         #######  #   ##      # #   ## #######,#.####.###.#.####....#.###########.####...#.###.####.#.###...#.#..###.........##
######## ### #########  ### ## #####     ###   ,#.#.#..#####...#####...#.##..###........#####...##.#.###...#.....#########.#####
##     ####   # ### ###  ####   # #  # # # ####,,,#.#.##.....#...#.###...###.#.#.##.###...##..####.#..##.####.##..#.....##.....#
#  # #      #   # #  ###  ##  # # ########      #,,,,,########.#.....###.#.....######.#.###..##..#.#.###....#..##...#.#####.##.#
####### ####### # ##   ## #  ##         #  #### # # #,,,#.#.######.#.#...#####..##.#....#.##.##.##.#.....#########.##.###.######
### # ####### #   #  #      ###########   ####### # ###,,,#.#.##.#.#####.##.###..#.####......##......#.####.##..##..#..........#
# # # ##        # ## ##### ##           ####      # ##  #,,,,,,,,,,,#.##......##...##.###.#####.###.##.......#.###.##.##.####.##
#        # # # ## #####     ######## ## #    ############## # # ###,,,#######.###.##..#...#.#.#...#..##.######...####.##....#.##
# # # # ########  # ##  # #  ###      ############ #        ######  #,,#..........###.###.......####.##........#....#.#..####..#
########### ##### # ##########   # # #### # ##       ### ##### # #####,#########.##...##..#####...#####.#.#.#.####.#####....#.##
## # # # #   #      # ## # ##  #######       #### # #######  #     # #,,,,##,,,,,####.###....###### # #######....####  ###.##..#
#        ### ######           ### # ######## ## ###### ## ## #####   ####,,,,###,,,,,,,...#### ##           #.##### ## ###..####
# ######     # ##   #### ## ###        ##### ## ## ##           #### #    ######## # #,##         # ## # # ###### # #    #######
### #### # #      # #    #  ######## #                # # ##### # ##   # ##        # #,#  ###### #########            # ### #  #
##       # # # # ## # ##### #   #  #### ##### ## # # ########        ###### # ## # # #,##      #      # ## ### ##########     ##
#  ##### #######  #####     ###   ####  #     #  # ######     ## ###### # #####  # # #, ## ## ### # ###  #   #####   # ## ######
# ##  ##### # #  ########## #   #      ### # ### #### # #### ##  ## #           ## ###,### #### ###     ######   # #    #    # #
#####           ### # # # ##### # # # ###  ###   #      # #   ## #    ## ## # # #  # ,,##        ######## ## ## ## ## #   #### #
## ### ## ## ## #          #    ### # #   ##   # #### #     ######## ###### # # # ###,#### ## ##   #       #        ### #      #
#   #   #### #  # # # ## #   ## ### ### #  ### ###    # # #  # #     # #    ### ### #,##   ##  # #   ## ##   ## # #  ####### # #
### ###### # # ###### #  ### ## #   ##  # ##   #   # #### # ##   ### #   # ##   ##   ,,## ### ## ###  ##### ##  # ##  ## #######
##   ## #    ### #    ## #   #  # #  ## # #### ##### #    #  ## ##   # # #  ## ##  # #,#####   #   ##     # ### # #####        #
#  #      # ##     ##  #### ### # ## #  # #    ####  ## # ##### ### ## # # ######### #,,,  ## ### ##  # ###  ## #       ########
## ###### # #### #######     ## # #  # ## ## # #    ##  #  ##   # # ## # # # #       # #,# ##  ##  # ##   # ##  # # # #  ##### #
####      ### #  #       # # #  #### # ##  ### ### #######  #####   #  #####   ## ## # #,#### ###### ## # ##### # # # ##       #
##### ## ##     ######## # ####  # ### ### #   ### ##  # # ##     # ############# #  # #,,,,#  # #####  #    ## # # ###  # #####
##    #   ## # ## #      ###    ## ##   ########   ### # #  ## ####  ### # ###    ## # ####,####     ## # #########   ####     #
#  # ## # ## ###    ## # #### # #   ##### #      # #       ##  #    ##         ##  # #    #,#### ########### #   ## #  ##  # ###
# ## ## #  ###   # #######  ###### ###    ############## #  ## # ############# #  ##### # #,,,,,  #            #### # ##  ## ###
# #  #  ######## #  # # ### ## ##    #### ###     #    # # ####### # #         ## ##    # # # #,#   # ## # #####  # # ###  #   #
### ###### #     ####    ## ## #  #### ## # ##### ## #   ###    #    ###### ##  #  ### ## # # #,# # #  # #  ###  ## # #   ## # #
#   ##     ### #  ###### ##    ##  ##   # # # ##  #### #  #####   ##    #   ### ####   #  # # #,##### ## ##   # ##  # ### ## # #
# #  ## ##  #  ####  # # ##### #  ##### # #    ## # #  # ##  ####  ## #   #   # ##   # # #### #,,# #######  #    #### #   ## # #
######  ###   ### ##             ##       #### ## #   ####  ## ### ## # # # #####  # # #    # ##,        # ### #  ###### #######
#  ##  ##   # #    ## ## ## ## #  ###### ####       # ##   ##       # ### #  #  ## ### # # ## # ,###########   ##    ##        #
##    #### ##### #    #  ## ##### # ##   ##   # # ### ## #    # # # ####  ##   ##  #   # #  # ##,,,,## # ######## ###### # # # #
#### ##       ##### # ####### # #      # ###### # #   ## ## ### ### ##   ##  #  ###### ### ###### #,##   # #    ###### ### ### #
#     ## ## ###     ###           ## # #        # ## ##  ## ##   ## ####  ## ######     ##  ## ## #,,# ### ## #####     ##  ## #
# # # ##### #### ####   ## # ############ ## ## # ## #  ##   ## ##### ### #  ##     ## ####     # ##,,,,,,,         ## ### ### #
##### # #   #    #    # ##########        #  ####  # ##  ###  ###         ## ### # ##   # ## # ###### # ##,###########   #   ###
##### # ### # # ### # # #          ### ##### #    ####  ##   ####### ### ##  #   #  ### # ## #  ##### ####,,         ###########
# # ### ### ### # ##### ####### ## ### ##    #### # ###  ## ##       #   ### ## ## ##     #### ## ##   # ##,#### # #           #
#    #    #######  # #### # #    ###   ## ####        ##  ####### # ## #   ###  ## ### ##   ##  # ## #   ##,   # ### ### #######
# ## # ## ### ####     #      # ##   #  ####   # # # ### ##   #   #  ### ######  #  ## #  #  ##   ## # # # ,## ####   ##  # #  #
####   ##       ###### ##### ## ## # ####    # # ### # ###### ### # ###  ###    ###  # #### ##  # #### # ##, #    ## ####     ##
#    #  ##### #   ## # #     ## ## #### ### ## # ##### ## # # #   # #   ## # # ##   #####    ####   ## # ##,#### ##   # ### ####
### #######   ###        # # ## #  #        #  #   ##           # ########   #  # #   ##  ##   ### ### # ##,####  # #   ##    ##
#   ##      # ##  # # # ## #  ####### # # # #### ##### # # ## # # ##       ### ######  # ##  # # # # # # ##,,# ############ #  #
## ##  # # ##  ############## ## ## # # ###   ##  ## ### #### # # ## # # # ###     ## ## #  ##   #   # #####,   # ## #   ## # ##
#  #######  ## #     #### # # #       ###   ##### ##     ##   # # ## #######   # # #   ####  ## ## # ####   ,#### #    #### #  #
# ## ## ###  #### ##  #   # # ## # # ######   ##  ## # #  ### ### ##  ##  ### #### ## ##    ###  # # ##   ##,####   ##    ######
# #         #########   #     #### ###  #   #  ####### ## #   ##  ## ####        ######## #   ## # #  # # ##,,,,## #########   #
### # ######## # # #  # # ## ## #  ####   # # ##       ## ###  ## ## ## #### #######      ### ## ### ######  ##,,# ## ## ##  # #
### #  #####         ## # #  ##   ## ### ## # #### # # #  #   ### #  #       ##    ######   ####  ##   #  ## ###,,, #  #    ####
#   ####   ## # # ## ## #### #  # #  # ###  #  ##  ### ## # ### ######## ###    #####     #    # #### ## #####   #,## ## #### ##
### #    #    # # ##  ####   #######   ### ## ##  ###########    #       #   ##     #### ## # #### #     ##    # #,,,,,,,      #
#   ######### ### ### #    #  ########      ###  ##     ###   ##   ## # #### ## # ####    # # # #    ## ### # ## # # ###,##### #
# # #          ## #   # ## #### # # ### # ######  ## ##     # #### ## # ##   ## #  ##  # ###### # ##  #   # # #  # #  ##,   ####
# #### ## # ## ##########  #            #      ## #  ## # # # #     ###  ## ##  # ### ##        ##### # # ##### #### ## ,#### ##
# ##   #  # ##    ##      ### ### ## # ### ## ### ##  # ########## ###  ##   ## # #   ## # # # #### # # #  ##   ##    ##,      #
###  # ## #  ## ###  ## # #   #    ### # # ##   #  ## # #    ##      ## #  # #  ##### ## # # #      # # # ##  #  #### ##,#### ##
#### # #  ####    ## ############ ##   #   ## ####### # ## #  ### # ##  ## ####### ##  ### ### ## ### # # #  ### ###  ##,,  #  #
#    ######    #######   # # #    ## # ## ##      ##  # #####     #  ## #  ## ##      #######  ##   ### # ####   # ######,### ##
# # ### ########    ####   #   # ##  ###   ## ## ######## # ## ## # ########     ## #     ##  ### # ##  # ##   #       ##,######
# # ##       ###### #  ### # # #  ## #   # #   ### #           #  # #  ## ##### ##### ## #### ##  #  ## # ## # ## ## ### ,,,   #
###  ## ####   ## # ## # # # # # ##  # # # # #  #  #### ### # ## #####           ##   ##  ##   # ### ## ###  # #  ##   ## #,## #
#   #####    #               ### #  ## # # #### # #######   #### ##  ####### # #  ## ##  #### ####   #   ## #### ##  ###  #, # #
## ##   ################# # ##   ##  ##### ##     ##   #  #  ##   ##         # # ###  ##   ##  ####### #  # ##    ##  ## ##,## #
###### ##     ####        ##### ##  ##     ## # #  ###   ### #  # #  ## # # ## #   # ### #  ##   #  ## # ## ## # ##  ##  # ,## #
# #       # #    ##### # ### ##### ##  # # ## # #### ###  ##### # ## #  ### ##### #####  # #####   ##  #  # ## #  ## ######, # #
# ####### ######       # ##    ##   #### #  ### ##       ##   # ###  ## ##   ##       ## #  ##   ##### # ####  # ##    ##  ,## #
# # ######## # ####### # ## ##    #   ## # ##    # ## ## ## #   ########### ##  # ## ##### ##  #    ## #########  # ##  # #, # #
#        ##            ######  # ### ##  # ## ## #######  ### ###   # #     ## ## ##   ###  #### ####    ##      ##  ## # #,## #
########  ###### # # #   ##   ##   #  ## ######  #       ##   ##  #     ###  ###  ## #   #####    # ## # ### # #  # ##  ###, # #
#   ## ##     #  # # ## #####  # # ## #  ### ### ## # ## ####  ## ## # ##   ##   ##  # #  ##   ##    # #  ## # ## #  ######,## #
###     #####   ## # ## #     #### #### ##        ### #   ##  ##  ####### #  ## #### # ####  #  ## ########  # ## ##  ##   , # #
#######  ##   # #### ## # ## ## #   ### #  ## ## #### ## ##  ##  ## #     # ###    ###    ## ## ##        #### #  #  ### ##,####
#       ##  # #  ### ## ###     # ###   ## #   # #    ##  ## #  ##    #####   ######## ##### ##  ################ # ## ###,,   #
# # ###    ## ####   ##  ## # ### ##  # #  # # # ## #  ##  ####  #### #     ####  ##       # ###    ## ####    ## # #    ,,# # #
####### # ##   ### #  ## ## #  ##  ## # ## ### #  ### ##  ##    ## #  ### # ##   ##  # ##### #   ##         ##  # # # # #,#### #
###     ##### ##   # ##  ## ##  ##  #####  #   # ##   ### ### # #    ##   #    ###  ##     #### #### # ######## #########,  ## #
#   ### ###    ##### #  #######  #####    ### ##### #  ## #   # ### #### ### #   ####  # #  ##    ####   ### ######  #  ,,# ## #
## ##     ## # #     # ##  # ## ###    ##   # #     # ##  ### # ##  #  ###   # # #    ## ####  # ##    #       ## ## ###,## ## #
#  ## ## ##  ### ## ##  ##      ##  ## #  # # # ## ####  ##########   ##   # # ### # ##    ## ## #  # ### # ##  # #     ,,# ## #
########  ## ### ##  # #### # #  ## #  ## # ###  ### ###### ##      ###  # # # #   #  ## ###  #  ## #  ####  ## #   # # #,###  #
#        #####   #  ##  ##  # # ##  ## #  #  ### #           # ## #   ###### # ### ## ## # #### ##  ##    ##### # # # # #,  ## #
##### # ## ##  # # ### ##  ## ###  ##  #####   # # ### ### #    ### ### # #######   ###      ##  ## ## # #### ### ### # #,######
#     ###     #### #    #####   # ##  ###    ########  #   # # ##   ##      # ##  # ##### ##  ## #   ###    # ##  ##  # #,,,,  #
### #  ### # ##    # # ####   ###  #####  ## ## #     ### ## # #### ## # ##      #### ###  # ##  # ####  # ## ### ## ## ####,###
#   # ##   #  # # ## # #    #  ## ##     ##  #    ## ##   #  # #    ## # #  # # ##        ##  ## #  ##  ##     ##  # #  #   ,,,#
##############################################################################################################################,#
