# ##############################################################################################################################
#   # ##  #       # #  # ## # #  ##  # # # # # # # # ##      ##  #  ##  # ##  ##  # ## #  ## ## ## #   # ##  # # # # ##        #
# #    ##   # ## ## ##   ##   ##  ##               # #  ######## ##  ## #    ##  ##    # ##      # ## ## #  ## # # # #  ########
#### #  ######## ##  # ##### ##  ####### ### ## ##   ##  #  # #  ### ##   ######  ## #    # ###### #  ## # ##    # # ##      # #
####### # ## #    ## #       ### ##      #    ######  ## # ## ## #   #  ###    # ###### #      ### ## #     ## ###    # ###### #
# #  ##    #   ##    ## ## #      #### # ## ##### ### ## #  # #  ### ##  #### ##  #  ##### ##### # ## # # #  # # # #### ## ##  #
# # ##  ##   # ### #     # ### ## # ####### #         ## # ## ## #    ##  ##  #  ## ## #   ## #  # ## # ###### # # ## #  #  ## #
# #  ###########   ## # ######### # # # # ######### #       # ## ### ####  ##   ### ## # #  #   ##  # # ## ##    # ## # ## ##  #
# ##      ### #########  ##             # ## ##     #### #### ## ##  # ### ## ### # #  ####   ##### #    # #  #### ##    # ## ##
#  # #### #      ### ########## # # ###    #  #### ####   ##   # ## ##  #   # ##  # ## ## ## ### ## # #### ## ###  #  # ##  #  #
##   #### ###### # #  ## ##     # ###   ##   ##  # ## ## #####   ##  ## # ###  ## # #  ## ##   # ## #  ##  ## # # ## ######   ##
### ##         # # ## ##  ##### ####  # #### ### ###      ######  ## #        ### # ## ##  ## ## ## # #### ## #    # # # #  #  #
# ##### ## # #      #    ##  ##### ###### ##      #  ## #  # ### ##  ### # #####     #  ## ##  # #  #  # #  # # ####     ## ####
# ## ########### ## ####  ##  #    #  ###    ## #   ######       ### #   ##### ##### # ##  ## ##   ## ##   ##    ### ### ##  ###
# #  # #  # # ##### ###  #### #### # ##   ######### ## ##  ## ## # # ###  #  # ## #     ## #   ## ##     ###  ## # #   #### ## #
# ## # ##      ## # # ## ##    # #    #######  ## ###   ## ##### #   # # ## ## ## ## ####  ### #   # ##### #####     #  ##   # #
#    # ###### ##       #  ## #   ####   ### ##    #####  # # #     #   #     # #  #   # ## ###   # # # ###  ## # ######### ### #
# ##    ## #  #  ## ##   #######      ###    ### ## # ## ### ######### #### ## ## # # # ## # # #####     ##    #   ## # #    # #
###### ##  ## ##########  # ## ### ##  #####      # #     #    ##   #  ##    # ## # ###  # #   # ##  ######### # ####   # #### #
#  #    ##         ## ### # ##   ##### # # ###### # ##### ####  ### ##  #### # ## # #### # ## ## ## ## # # # #   ## ## ##  # # #
## #### ########## ##     # ## ##### #       #      # #        ##    ## ## # #  # # # #    ##            # # # #### #   ##     #
#                  ######   ##  ## # ### ### ###### # ########  ####           ## # # ####    # ## ## ####     ##   # ###  #####
##### ## # #### ## # # #### #  ### # ### #   # #      # ##     ###   # ####### #  # # #  ### ##########  ### #    # #   ##     #
## ##########   #             ## # # # #####   ###### #  ##### # #########  #  ##   # ## ##    ##    ## ##   #### ### ###  #####
#    # ## # ## ##### ### ## #      # # ##  ## ## #### ## # ##      ## #  ## ## ## # #  #  ## #    ##### ## ########   ####     #
## #   ##   ####     #   ## ## ###     ###            #       #### ## ##          ### ## ##  ### ## #             ### # ## ## ##
#  # #  ## ## ######### ############## # ######### ##   # #######     ###### ####  ##  #  ##  ##### ### ####### ###   # #   ####
# #####        #    ###### ##       ##   ##     ## ###########    # #        #  ## ### # ### ## ##   ## ## ## ### ### # # ######
####    # # ##   ##  # #    # ## ##    ########  # #     #     # ## ## ### # ##      #   # #     ## ##  #      ##  ##       # ##
#    # #############   #### ####### ## # # #  # ######## ################  ##### # #   # # # #####   # ## ####### ##  # #####  #
########           ### ##    # ## ###  # # ## # # ##     # ###  # ## ###  ### #  ##### ### # ## #### # #  #  ###  ## ##  # ## ##
##### ### # # # ##   #  #### # #   ###          # ## ###     ##   ## # ## #     ####    #     #  ##      ## ## ##     #### ##  #
#         #######  #   ##      # #   ## ####### # #### ### # ####    # ########### ####   # ### #### # ###   # #  ###         ##
######## ### #########  ### ## #####     ###    # # #  #####   #####   # ##  ###        #####   ## # ###   #     ######### #####
##     ####   # ### ###  ####   # #  # # # ####   # # ##     #   # ###   ### # # ## ###   ##  #### #  ## #### ##  #     ##     #
#  # #      #   # #  ###  ##  # # ########      #     ######## #     ### #     ###### # ###  ##  # # ###    #  ##   # ##### ## #
####### ####### # ##   ## #  ##         #  #### # # #   # # ###### # #   #####  ## #    # ## ## ## #     ######### ## ### ######
### # ####### #   #  #      ###########   ####### # ###   # # ## # ##### ## ###  # ####      ##      # #### ##  ##  #          #
# # # ##        # ## ##### ##           ####      # ##  #           # ##      ##   ## ### ##### ### ##       # ### ## ## #### ##
#        # # # ## #####     ######## ## #    ############## # # ###   ####### ### ##  #   # # #   #  ## ######   #### ##    # ##
# # # # ########  # ##  # #  ###      ############ #        ######  #  #          ### ###       #### ##        #    # #  ####  #
########### ##### # ##########   # # #### # ##       ### ##### # ##### ######### ##   ##  #####   ##### # # # #### #####    # ##
## # # # #   #      # ## # ##  #######       #### # #######  #     # #    ##     #### ###    ###### # #######    ####  ### ##  #
#        ### ######           ### # ######## ## ###### ## ## #####   ####    ###          #### ##           # ##### ## ###  ####
# ######     # ##   #### ## ###        ##### ## ## ##           #### #    ######## # # ##         # ## # # ###### # #    #######
### #### # #      # #    #  ######## #                # # ##### # ##   # ##        # # #  ###### #########            # ### #  #
##       # # # # ## # ##### #   #  #### ##### ## # # ########        ###### # ## # # # ##      #      # ## ### ##########     ##
#  ##### #######  #####     ###   ####  #     #  # ######     ## ###### # #####  # # #  ## ## ### # ###  #   #####   # ## ######
# ##  ##### # #  ########## #   #      ### # ### #### # #### ##  ## #           ## ### ### #### ###     ######   # #    #    # #
#####           ### # # # ##### # # # ###  ###   #      # #   ## #    ## ## # # #  #   ##        ######## ## ## ## ## #   #### #
## ### ## ## ## #          #    ### # #   ##   # #### #     ######## ###### # # # ### #### ## ##   #       #        ### #      #
#   #   #### #  # # # ## #   ## ### ### #  ### ###    # # #  # #     # #    ### ### # ##   ##  # #   ## ##   ## # #  ####### # #
### ###### # # ###### #  ### ## #   ##  # ##   #   # #### # ##   ### #   # ##   ##     ## ### ## ###  ##### ##  # ##  ## #######
##   ## #    ### #    ## #   #  # #  ## # #### ##### #    #  ## ##   # # #  ## ##  # # #####   #   ##     # ### # #####        #
#  #      # ##     ##  #### ### # ## #  # #    ####  ## # ##### ### ## # # ######### #     ## ### ##  # ###  ## #       ########
## ###### # #### #######     ## # #  # ## ## # #    ##  #  ##   # # ## # # # #       # # # ##  ##  # ##   # ##  # # # #  ##### #
####      ### #  #       # # #  #### # ##  ### ### #######  #####   #  #####   ## ## # # #### ###### ## # ##### # # # ##       #
##### ## ##     ######## # ####  # ### ### #   ### ##  # # ##     # ############# #  # #    #  # #####  #    ## # # ###  # #####
##    #   ## # ## #      ###    ## ##   ########   ### # #  ## ####  ### # ###    ## # #### ####     ## # #########   ####     #
#  # ## # ## ###    ## # #### # #   ##### #      # #       ##  #    ##         ##  # #    # #### ########### #   ## #  ##  # ###
# ## ## #  ###   # #######  ###### ###    ############## #  ## # ############# #  ##### # #       #            #### # ##  ## ###
# #  #  ######## #  # # ### ## ##    #### ###     #    # # ####### # #         ## ##    # # # # #   # ## # #####  # # ###  #   #
### ###### #     ####    ## ## #  #### ## # ##### ## #   ###    #    ###### ##  #  ### ## # # # # # #  # #  ###  ## # #   ## # #
#   ##     ### #  ###### ##    ##  ##   # # # ##  #### #  #####   ##    #   ### ####   #  # # # ##### ## ##   # ##  # ### ## # #
# #  ## ##  #  ####  # # ##### #  ##### # #    ## # #  # ##  ####  ## #   #   # ##   # # #### #  # #######  #    #### #   ## # #
######  ###   ### ##             ##       #### ## #   ####  ## ### ## # # # #####  # # #    # ##         # ### #  ###### #######
#  ##  ##   # #    ## ## ## ## #  ###### ####       # ##   ##       # ### #  #  ## ### # # ## #  ###########   ##    ##        #
##    #### ##### #    #  ## ##### # ##   ##   # # ### ## #    # # # ####  ##   ##  #   # #  # ##    ## # ######## ###### # # # #
#### ##       ##### # ####### # #      # ###### # #   ## ## ### ### ##   ##  #  ###### ### ###### # ##   # #    ###### ### ### #
#     ## ## ###     ###           ## # #        # ## ##  ## ##   ## ####  ## ######     ##  ## ## #  # ### ## #####     ##  ## #
# # # ##### #### ####   ## # ############ ## ## # ## #  ##   ## ##### ### #  ##     ## ####     # ##                ## ### ### #
##### # #   #    #    # ##########        #  ####  # ##  ###  ###         ## ### # ##   # ## # ###### # ## ###########   #   ###
##### # ### # # ### # # #          ### ##### #    ####  ##   ####### ### ##  #   #  ### # ## #  ##### ####           ###########
# # ### ### ### # ##### ####### ## ### ##    #### # ###  ## ##       #   ### ## ## ##     #### ## ##   # ## #### # #           #
#    #    #######  # #### # #    ###   ## ####        ##  ####### # ## #   ###  ## ### ##   ##  # ## #   ##    # ### ### #######
# ## # ## ### ####     #      # ##   #  ####   # # # ### ##   #   #  ### ######  #  ## #  #  ##   ## # # #  ## ####   ##  # #  #
####   ##       ###### ##### ## ## # ####    # # ### # ###### ### # ###  ###    ###  # #### ##  # #### # ##  #    ## ####     ##
#    #  ##### #   ## # #     ## ## #### ### ## # ##### ## # # #   # #   ## # # ##   #####    ####   ## # ## #### ##   # ### ####
### #######   ###        # # ## #  #        #  #   ##           # ########   #  # #   ##  ##   ### ### # ## ####  # #   ##    ##
#   ##      # ##  # # # ## #  ####### # # # #### ##### # # ## # # ##       ### ######  # ##  # # # # # # ##  # ############ #  #
## ##  # # ##  ############## ## ## # # ###   ##  ## ### #### # # ## # # # ###     ## ## #  ##   #   # #####    # ## #   ## # ##
#  #######  ## #     #### # # #       ###   ##### ##     ##   # # ## #######   # # #   ####  ## ## # ####    #### #    #### #  #
# ## ## ###  #### ##  #   # # ## # # ######   ##  ## # #  ### ### ##  ##  ### #### ## ##    ###  # # ##   ## ####   ##    ######
# #         #########   #     #### ###  #   #  ####### ## #   ##  ## ####        ######## #   ## # #  # # ##    ## #########   #
### # ######## # # #  # # ## ## #  ####   # # ##       ## ###  ## ## ## #### #######      ### ## ### ######  ##  # ## ## ##  # #
### #  #####         ## # #  ##   ## ### ## # #### # # #  #   ### #  #       ##    ######   ####  ##   #  ## ###    #  #    ####
#   ####   ## # # ## ## #### #  # #  # ###  #  ##  ### ## # ### ######## ###    #####     #    # #### ## #####   # ## ## #### ##
### #    #    # # ##  ####   #######   ### ## ##  ###########    #       #   ##     #### ## # #### #     ##    # #             #
#   ######### ### ### #    #  ########      ###  ##     ###   ##   ## # #### ## # ####    # # # #    ## ### # ## # # ### ##### #
# # #          ## #   # ## #### # # ### # ######  ## ##     # #### ## # ##   ## #  ##  # ###### # ##  #   # # #  # #  ##    ####
# #### ## # ## ##########  #            #      ## #  ## # # # #     ###  ## ##  # ### ##        ##### # # ##### #### ##  #### ##
# ##   #  # ##    ##      ### ### ## # ### ## ### ##  # ########## ###  ##   ## # #   ## # # # #### # # #  ##   ##    ##       #
###  # ## #  ## ###  ## # #   #    ### # # ##   #  ## # #    ##      ## #  # #  ##### ## # # #      # # # ##  #  #### ## #### ##
#### # #  ####    ## ############ ##   #   ## ####### # ## #  ### # ##  ## ####### ##  ### ### ## ### # # #  ### ###  ##    #  #
#    ######    #######   # # #    ## # ## ##      ##  # #####     #  ## #  ## ##      #######  ##   ### # ####   # ###### ### ##
# # ### ########    ####   #   # ##  ###   ## ## ######## # ## ## # ########     ## #     ##  ### # ##  # ##   #       ## ######
# # ##       ###### #  ### # # #  ## #   # #   ### #           #  # #  ## ##### ##### ## #### ##  #  ## # ## # ## ## ###       #
###  ## ####   ## # ## # # # # # ##  # # # # #  #  #### ### # ## #####           ##   ##  ##   # ### ## ###  # #  ##   ## # ## #
#   #####    #               ### #  ## # # #### # #######   #### ##  ####### # #  ## ##  #### ####   #   ## #### ##  ###  #  # #
## ##   ################# # ##   ##  ##### ##     ##   #  #  ##   ##         # # ###  ##   ##  ####### #  # ##    ##  ## ## ## #
###### ##     ####        ##### ##  ##     ## # #  ###   ### #  # #  ## # # ## #   # ### #  ##   #  ## # ## ## # ##  ##  #  ## #
# #       # #    ##### # ### ##### ##  # # ## # #### ###  ##### # ## #  ### ##### #####  # #####   ##  #  # ## #  ## ######  # #
# ####### ######       # ##    ##   #### #  ### ##       ##   # ###  ## ##   ##       ## #  ##   ##### # ####  # ##    ##   ## #
# # ######## # ####### # ## ##    #   ## # ##    # ## ## ## #   ########### ##  # ## ##### ##  #    ## #########  # ##  # #  # #
#        ##            ######  # ### ##  # ## ## #######  ### ###   # #     ## ## ##   ###  #### ####    ##      ##  ## # # ## #
########  ###### # # #   ##   ##   #  ## ######  #       ##   ##  #     ###  ###  ## #   #####    # ## # ### # #  # ##  ###  # #
#   ## ##     #  # # ## #####  # # ## #  ### ### ## # ## ####  ## ## # ##   ##   ##  # #  ##   ##    # #  ## # ## #  ###### ## #
###     #####   ## # ## #     #### #### ##        ### #   ##  ##  ####### #  ## #### # ####  #  ## ########  # ## ##  ##     # #
#######  ##   # #### ## # ## ## #   ### #  ## ## #### ## ##  ##  ## #     # ###    ###    ## ## ##        #### #  #  ### ## ####
#       ##  # #  ### ## ###     # ###   ## #   # #    ##  ## #  ##    #####   ######## ##### ##  ################ # ## ###     #
# # ###    ## ####   ##  ## # ### ##  # #  # # # ## #  ##  ####  #### #     ####  ##       # ###    ## ####    ## # #      # # #
####### # ##   ### #  ## ## #  ##  ## # ## ### #  ### ##  ##    ## #  ### # ##   ##  # ##### #   ##         ##  # # # # # #### #
###     ##### ##   # ##  ## ##  ##  #####  #   # ##   ### ### # #    ##   #    ###  ##     #### #### # ######## #########   ## #
#   ### ###    ##### #  #######  #####    ### ##### #  ## #   # ### #### ### #   ####  # #  ##    ####   ### ######  #    # ## #
## ##     ## # #     # ##  # ## ###    ##   # #     # ##  ### # ##  #  ###   # # #    ## ####  # ##    #       ## ## ### ## ## #
#  ## ## ##  ### ## ##  ##      ##  ## #  # # # ## ####  ##########   ##   # # ### # ##    ## ## #  # ### # ##  # #       # ## #
########  ## ### ##  # #### # #  ## #  ## # ###  ### ###### ##      ###  # # # #   #  ## ###  #  ## #  ####  ## #   # # # ###  #
#        #####   #  ##  ##  # # ##  ## #  #  ### #           # ## #   ###### # ### ## ## # #### ##  ##    ##### # # # # #   ## #
##### # ## ##  # # ### ##  ## ###  ##  #####   # # ### ### #    ### ### # #######   ###      ##  ## ## # #### ### ### # # ######
#     ###     #### #    #####   # ##  ###    ########  #   # # ##   ##      # ##  # ##### ##  ## #   ###    # ##  ##  # #      #
### #  ### # ##    # # ####   ###  #####  ## ## #     ### ## # #### ## # ##      #### ###  # ##  # ####  # ## ### ## ## #### ###
#   # ##   #  # # ## # #    #  ## ##     ##  #    ## ##   #  # #    ## # #  # # ##        ##  ## #  ##  ##     ##  # #  #      #
############################################################################################################################## #
