# ###################################################################################################################################################################
#  ##   #    ## ## # # ##  # #       # ## ## # # # # # # #                        #  #    ##  ## # #  ## #  ##   ##  # #  ## #  # # # # # ##        ##  ## ### ##   #
## #### ## ###  #  #    ## # ### ### # #               # ##### ######### # # # ## ##   ##  ##    # # ##  ## #### ### # ## ## ##              ######### ##   #  ## ###
#  # #   # # ## ## ####        ##### # ############# # # # ##### #### ##########   # ##### ##### #    ## #  #  # #   # ## #     ### # ######              #   ##    #
## #   #   #  # ## # #### #### ##       ## # #       #              #   # # #    #    ## # # # # ### ##  ## ## #   #    # ## ## ##  # #      # ##### # ## ## ##  ####
#    ##### ##          ####     ##### #        ## ## # # ## # ## ##   #     ###########               ##         # ## #      #   ## ### # # ##     # ###   ##### # ##
####### ## ## ### # ## # ######   ###### ### ########### #  ############### # # # ### ### # # # # ## #### # ############ # # ## ########### ############ #  # #     #
#          ##########     ##  ## ## ## ###   ##  #  #    # ##                             # ##### #   ##  # ##    ## # ### # ##   ##             ##    # ##     # ###
### # #### # #   # ###### ###    ##        #  ## ## #### #  ########### ### ## # ####### #####    ### ###########          #  ## ### # #### # ##    ## #  # # # #  ##
# ######   # ###      #     ####    # # # ### #   #   ####### # ######  #   #  # #   ######    ####     ## ## ###### ## ## ## #### #####    #  ## #  #### # ### ##  #
# #####  # # #### ### ##### ## ### ######## ##### ###   ##             #############   ##   ## #    ###              #  #  ####     # #### ###  ### ### ########## ##
# # # #### # # #####    #    # # ### # # ## ##        ####### ## # ## ##      #    ### ### ############## ######## #### ##  #######    #   # ##  #### # ## #     ####
# # # #        # #   ## ## #     ### # #  #  # # ####  # ## ########  ## #### #### # # # ####### # ##     #        ##   ### #       ##   # # #  ##       # # ###### #
#       # ####   #####     # ## ##     ## # ########## # #   ## # ### #  #    ##          # ## #      ## #### ## #  ##### ######## ##  # #   ##  # ## ##       # #  #
### #######    #   ##  ######## ###### ## # ### #          # ## # # # # ##### ####### ### # ## ### # ##   ######## ####   ## ## ##  ###### #  ##    ###### ###     ##
######## ### # # #  # ####  #    ##          #  # #### # ### ##     ######  #  #      #   # #      # ######     #####   #          ##      # ### ##  #   #   # ## ###
# ##      ## # # ##   ## ## #### ## ## ##### ## ###  ######   ### # ## # ## ## ## # # ### # ########## ##   # #  ##   # ## ### # # ####### ###   ###   #### ## #    #
# ### # #    # ##### ### #   ##   ###### #       #  ### # ## ## ### ##          #########     ##  # #   ##### ##    ### #  #   # # #       ##  #   # #### #  # ## # #
#   ############## ####    #  ### ##  ## ####### ## # # #    #  ##   ########## ## # ## ##### ### # ## ##     #### ##   ## ## ## # #### # ##  ### ##      ## # ## # #
# #### #           ## ####### # #  ##    # #     ##     #### ##  ## ## ##          #  #  ####             ### #    ### ##   # #  ###### #  ## ##   ############## # #
#  ##    ######### #    #       ## ### #   #####  ##### ###   ## #  ##  ########## ## ##      ####### ## ######## ## #  ## #######      ## ## #  #    ##### #   # ###
##  ###### ### ### #### ##### #     ######     # ##   # # ###  # ## ### ##            ####### ##      #  ##       #    ##### # ########  # ## ## # ##         ###   #
### # # ##     #         # ####### ## #    ###    ### # # # ##    #      ############ # # # ###  # #####  # # # #### #  ##              ## ## ## ###  ######### ### #
#       ## ### #########     #     ## # ######### ##    # #  ####   # ##  ##  ## #### # #       ####     ## ######   # #### ######### # ##  # #    ##  ######    ####
### ## #####   # ##      ###   # #  # ###### #### #  ##   ## ###  # #####  ## #       #   # ## ## ### ##  ###      # ###  ### ####    # ## ## ### ####        ##    #
#   #  ####  #    ########### #####   ##     #      #####        ##    ###      ## ##   # # #      ## ## ########### ####          ## ###  ##  ##  # ####### ### ####
######  ##  ### #  #    ## #####    #    # #   ### ### #### ## # ## #### ## # # ####### ### ## #####   #### ## #        ######## #  ###   ##  ####         #   #    #
###    ###### #### #### #  # # ## # # # ## # # #   #        ## ###  ##    ####### #      ## ####     #  ##  #    #### ### # ###  # ###  # ## ##  ## ## # ############
# #### # # ##  #   # #  ## #      ### ###  ####### ## # # # ## ##  ######    # #    ### #####    ### ###### ## ########         ## ##  ## #  #  ##  ## #### ### ##  #
#  ###   #  ## ###   ##  # ##### ##     ##### # ## ###### #  ####### # ### #   ## # ###   ######  ## #    #  ###    ###### #### ########  ##   ##  ##              ##
## # ### # ##    ###  ## # ############## ##        ## #### ##   ##        # #    ### # ###  #   ######## ##  #####        ##     ##     ##  ######### ## ## ## #####
##          ####   ##           # # ### # #  # ## # #       ## #    # #### # ## # #       ## ###  # ## ## ###       # # # ##  ## ##  ## ####    ##     ##  ######## #
#  ######## ######    ## # # ##       #     ## #### # ## ##  #### # ### #  ########### # ##   ## ##  # ## # ###### ## # ###  ##  #  ##   ##  ###### ##  ##  ## ##   #
#####              ##  ### #  ### # #   ###  # #    # #  ### ## ######    ####         # #  #     ##   #            ########  #####  ## ####    ##  ## ##  ##   # ###
#     # ## # # ###  ################# # #### # # # ## ## #   #       ### ##  ###### # ## ## # # # ####   ####### # ##        ###  ## ## #    ## #  ##   ##    #     #
# ## ## ## ### #   ##     # # #       ###    ### # #  #  # # ### ###   ##### #      # ####### ##### ####### #    #  #### # #   ##     # ## # #### ##### ## # ## ## ##
###  #  #####  # #  ### #       ## ## ##  ##   ######### # # ##  ##### ## #    # # #### ##    ## #          #### ####### # # # ### # ## #  #   ##    ## #  # ## #####
##  ### #     ## # ####### # ####  ##  ## ## #  ##       #####  ##          ## # ###    #######    # # ## #       ##     # # #   # # ## ## # #  # # ###### #  #     #
#  ##   ## # ######## ## ######### ## ##  #  ##  ### # #### #  ########## # #  ######## # ###   ############ ## #  ## ## # # ## #### ## ## # ## # #######  # ########
## ########### ##           #      ######## ##  ###  # #      ##          #### #            ## ##            ## # ### ## # # ## ##    # ## #  ###    ##   ##        #
#   ##            #########   # ## # ## ##   ## ##  ## ##### ######### ##  ##  ## # ### # #    ## ### ## # # ####   #### # # ###### # ###  # ##   # #### #### ## ## #
# ##### ######## ### #      # # ## #       ###   ## #  ###   # #   # #### ####  #####   #### # ###### ## # ###    ###    ###    ##  #   ## # ## # # ## #  ##   ######
# #   # #        #   # ## #######  # # ###   # # ## ## #   # #   #    #      ##### ### ##    # #       # # #   ##   ## #   # ##  #### ###  # ## # # ##   #####      #
##### ############## ###  ###     ## ###   ##################### ####   # ####         #### ## ## ## ######### #  #  ### # #  ####      #### ## ### #  #   ##  ## # #
#       #######   ## ##  ## #### #########   ## ## #  #  ##### ######## # ######## ##### ##  ######  ## #   ## ## # ##   ####    #### ### #####   # # ### ##  ### # #
#### # ##     ### #     ##  # ## #         # ## ## ## ##   # # ###      # #  ##  #######    ##   ### #  ###    ####  ## ####  ####            # #######   ## ## #####
#  # #  ### #       # #  ##   #  ### ## # ## ##          #       #### # # # ####  #    # # ##  #     ##     ##  ##  ##     # ##    # # ### ####   ## #  # ## ## ## ##
# ##### # #### #### # # ##  #   ######### ## ## # # # # ######## ###  # ###  # ## ####   # ###### # #### # ##  ####  ## ####  ### ## #   #   ## ###    ####         #
# # ##    ########  # ######## ##          #### # # # ### ##         ####### #    ##### ##    # ### ##   # #  ## ### #   ##  ###  #  ## ## # ##   ### ##    # #######
# #  ### ## # #    ##### ##     ## # # ## ####  # #####      ### # # # ##      ## #      ## # #      ## ##### ##     ## ##  ## #### ##   # # ## # ##   ### ##       #
# # ## # ## # # ## # ##   ### # ## ### #  #    ##### ## ## # #   # # #    # #####   # # ### ### ## ######   # ## ## ##   ## ##       ### # # ## # ## ###    ## # # ##
#    # # ## # # ## #    #     ###   ##### ## # ##       ## #### ####### #######   ### # # #  ## #   ## ####    # ###### ##   ##### # ### # #### ###    ## ###### ####
## #     #      #  #### # # ######### ##   ############ ## ########## ####      #  ## # #   ### ## ##    #  # ## #       ## ##     ###   # ###  ##  # ##    ##      #
#  # ###   # ## ## #    ###  ## #      ### ## # ## #### #### # # # #     ## ## ## ##  # # #   #  #  ## #   ## ######### ##   # ###  ## # #   ###### #  # # ### # ####
# ###### # ########### ##   ##  # ## #     #            # #          # #  ###  ##  ## # #### ## #####  ## ###  ##   #   ## # #  ### ## # # #    ##### ## # ##  #    #
#  ##    #   ##         ###  ##   #  ## ## ### # #### ### #### #### ## ## #### #  ##### #     ### # ####  #   #####   #  # # #### #  # # # # ##  ##   #  ##### # # ##
# ##  #### ###### #####  ## #### ### #  ####   # #######       ###   ###       ## # ##  # ## #### #  ########   #### ## ## ###      #### ### ######## ## ### # ### ##
###  ##        ####     ##  ##     ####   #### # #   #   # # # #   ######## ## #    ### # #  #  # ## # # # ## # #    ## ## #   # ##   ##  ##   ##  ## ##     ###    #
#   ###### # ### ######  ## ### ######  ###  #######   # # # # ## ## #       ### # ## ### ## ##   #           ###### #   # ### #### #####  ## ####    ## # #   #### #
# # ##     # ##     #   ##  #   ## # ####### ## #    # # # ### ####    # # ##### ###       ###### ## # # ## #  ##    ## ## #   ##   ## #  ### #######  # # ##### #  #
### #  # # # ## ###   ##### # # #    ###          # #### #######    # ## ##### # ##### # ###         # # #### #### # #   # ## #####    ## ##   ##     #### ##      ##
#   ## ### ###### # #  ## # ### #### # ### #### # ########    #### #######       # # # ###   # # # # #####      #### # # # ##  # ## # ###  ## ##### #   ##  #### #  #
### #   ###### ##   ## #     #####      #   ##  # #  #  #####    ### ## ##### ##     ############# # ##    # ## #    # # # ### #    ###   ##     ## # #  ## #    ## #
#   ## ## ## #    ###### # # # #   #### ############ ##     ## #####           ## ##  ##   ## ##   #  ## # #  #### # # # #   ##### ##### ### ###  ### ######### ##  #
### ## #     ### ##      ##### ### #      # # ###  #    # #    # # # # ### ### ##  # ##### #     # # ##### # ##    # # ### # ###       # # #   ####     ## #    ### #
#   #  ### #      ## # # #  #    ###### #       ##   ## #### #       # #     ###  ## #     # # # # #  # ## ##### # # # #   ### ## ######   # #    ### # ## ####   # #
# ####  ##### ### ## ###### ####  #     ## ## #    # ## ##   # ## # ##### ##   ##  # ## ##   # ### # ##    ## #  # # # ###  ##       ##### # ## # ##  # ##      ### #
#### #### #   ##  ####  #      ## # # # ## #  # # ##  ###  # ###### ##     ## ##  ## ###### ## ##  #  #######   ## # # ##  ###### ##   #####  #####  ####  ####   ###
#    ## # # #  ## # ### ## # #      ######### # # #  ##   #####  ## ### # ### ## ##### ## # ## ## ## ##       # #  ### ## ##       ###     ##   ####   ## ###   #   #
#### #      # ##  #     ######## ######       ###### ## # #   ##    #   # #    #   ##     # ## ##  #### ## ## ### #### #  ### # ##  ## # # ## ###    ###  #   # #####
#      # ## ########### #  ##    #      ## # ### # ##########    # ## # # # # ### ##  # #   ## ## ###   ####  #   ##   ##  #### #  ### ###### ######   ## ## ##  # ##
#### # #### ##   # # ## # ##  ## # # # ##### #         # # ### # #  # # # # # ##  #  ## ## ##  ## #   # # ### ## ##  # ###  ##  ## # # ## # #     ## # ## ## ###    #
###### #    ## #     #       ##  # # # ##    #########         ### ###### # # ### ## ## #   ##  ##### ###     ##  ## # #   ##  ##  #        ### # ## # #  ## #   ## #
#      # # ##### # #   ### # #  ## # #  #### #         ### # ###   ##     # ### # #  ## ## ##  ##     ##  ### ## ### ### #  ##  ###### ######## ###  # ## ## ## ##  #
# ### ####   ######## ##   # # ##  # # ##    ###### ## #   ####  ##### # ## ###   ## #  ##### #### ##  ## ##  ## ##   ## ## #  ##   #         ################   ## #
###    ##  ### ## ##  ## # # # #  ## # ### # #      ##### ### ##     #####    ###  # ##  ##   ## #  ## #   ## ## #  # ####  ##  ###   # #####       # ## #     #  # #
##### ####  ## ##    ##### # # ## #  ###   ### ## #  ## ###      ## ##     ## ##  ###### #  # ##   ##  ######  # ## #  ##  #### #### ##     #### ## # ##   ### # ####
#     ##   ##   ## ###  #  # # #  ## #   ####   #### #   #### # ##   #####  #####     ##### #  ###  ####### # ####  ##  ## ##   #     # #############  # # ### #    #
# ## ##  # #  #    ####   ## ####  # # # ##   ##########      #  ##########     ## ####  #######   ##          ##  ### ##   ## ### ## #            ## ######   ## ###
###  ## ######### ##    # ##  # # ########  # # # ##     ## ### ## # #      # ###   # # ## # ##  # ### ### # #  #####   ## ##  #   #  # # # #### #      # ### ##    #
##  ##  ##     ##### ## #####   ### # #########      ######  ####    # ## # #   #####           ##  ######## ##  ##   #  # #  #### ## # ###    #### ###    ##  # ## #
#  ####  ## ##       #    # ## #### #  # # # #  #### ##     ##    ##    # # # # ########## #### ## ## #       ## ## # # #### ###   #  ###### #  ##    ## ##### # ####
# ##    ######## # # ## ### #  #  # ## # #     ## ###### # ###### #### ## ### ###       #### #  ## #    # # #  #  ### #   #### ######     ##### ### # ##  # #  #   ##
#  ## #  # #     # # #    # #####          # # ##   ## # # ##      ### #  ##  ### ##### # #    ##### # ## # ## ##  ## # ### #   ###   ###   ##   ## #### ##   ## #  #
# ###### #   # # # # # # ##       #### ## ## ###### ##   #  ### # ##   # #### #   #         # ##  #  # ## ####  # ### ###     #     #  ## #  #####     #  # ####### #
#  ##    ### # # # ### #  ####### #    #  ######       # # ##   # #  ### # ## ## ### # # ## #  ##   ## #   ##  ## #    ## # # ## # ### ## ##     # # ### ##     ##  #
# ##  # #### # ### #   #####      # ## # ## #    ### # # # #### #### ##  # ## #   #### #### ####  ###### #  ##  # ### ### #####  ###    ###  # ### #   #### # #### ##
# ## ####    # ##  # # #     # ## #### ####   # ##   #######     #######    ### ###    #     ####### ##  # ##  ## ######  ## ######  ##  #####  ##### ### # # ##    #
# #  ##   ## #  ## ####### # # #   ##  ###  # ###  # ## ##   ###  # #    ####   #   ########    ##      ##  ##  ###      ##         ####    ###  ## ####  # # ## # ##
# ## #### ## ####  #       ###### ######   ######### #     # ##  ## ## #  ### # # # #        # ##  ### ### ##  ###  ## # ### # ####   ## #### ##  # ##   ## #  ###  #
#  ###    ## ## ##############  #  ##    #####       ## # ## ### ##    ##   ############# # ##### ###    #  ## ##  ##  # #   # #    # ## ###   ##      ###### ##   ##
# ##   # ##  ##   # #  # ### ##   ######### #  ## ## ####  ### #  ### ##  # ## # ##  #### # ##  ###   #### ##   ##  ## ##### ##### ## #      # ## # ##  ## ##### # ##
# #  # #  ####### # ## #        # ##          ##   # #    ##     ###   ## ###     ##      #####  #  #    # #  # #  ###  ##   ##     ### # ## #  # #####  # # # # #  #
# # #######   #          ## ### ############# ## # # ## #  ##### #   #### ##  # #  ### # #######   ### ##### ## ##   ## #  # ##### ##   # ##### #  ## ##     # #### #
###  ## # ### #### ### # ## ##  #     #        # # ###  ######## ### #    ########  #  #    ###### ##     ## ## ## # ## ## # #     ### ##   ##  ##    ## ###     ## #
##  ##         ##### # # #   ## ## ##   ### # ####   # ##        #   # ## #  ### ## ## ## #  ##     ## ## ##  # #  # #############  ##### #  # #### # ##   #######  #
#  ###########         ### # ######## # #   #  ##  # ###### # # ### ##  ####  #        ## ##  ### #### ####  ## ####   # #### ##### # #   #### ## # # ## #       ## #
# ##           # ### # ##  # #        # # ### #### #### #   # # #   ## ### ## ##### # ###  #####  ###    #####  #    ### # #          ###    # ##   #  # ## # # ##  #
# ######### # ## ##  # #  ## ###### # # # ##  ## # ##     ######### ## ##           #   # #### # ## ### ## ###### ## ##      ## ## ##   ## ######## # ## ## ###  # ##
# #     #   # #  #  ##### #####     ### #  ## ##    ## # ##         ##  ## ## ## ## # # # #      #           ##   #   #### # ## ## #  ###     #  ## # ## ##   ## #  #
# #####   # # ## ## #   #  ###  ###  ## # ##  #### ##  # ####### ####  ######  ###  ######## ## #### ## ## #  ## #######   #  ###  ##   ## ##   ##  # ## ## #### # ##
### #   # # ###########   ## # #####  #######   ##  ####  ##     #    ## ##   #####    # # # #   ###  ###  # ### #    #  # #####  ##  #  # ### ###### ## #     # #  #
#     # # # ###  #  ##### #    ## ## ##       # ## ####  ####### # ## ## #  # ##    # ##     ## ##   ##   ##   ###### # ##### #  ### ### ### #     ## ## ## #### # ##
### # #######   ## ## ###########     # # ## ## ## #    ## ####  # ## #    ##  ## # #  ##### ##  ## #####  # ###        ##      ## # #       ## ## ## ## #    #######
#   ###########  # #         #    ## ## # #   #  # # ## ## #  ######### ## ## ##  #### ##     # ##    ### #### ## # # ####### #    # ## # ##  #  # ## ## # # ## #   #
## #### # # #### # ### ## ##   # ##   ###### ## ## ###  #  ##  ###  ######  #  # ##  #  ## ## # ### ###     #   #######       ## #####  #  # ## ####   # # #      ###
#  #          #        #   ## ## ####   ##   ## ####### ##  ##   ## # #    ## ######   ##  #  ###    ## # #   ####      ## ## ##  # ### ## # ##   ### ## # ## # #####
## # # # # ##   # ## #### ##  ## #    ###### ##  ### ######    #    # ####  # # #    #### ### ##  # ####### #    ## # # #  #  ## ##  ## #  #  ## ##   #########     #
#  # # ### #  # #######    ##########   ##    ####     # #  # ## ##        ## #   ## ##   #   #####     ##  ### ######### ### ##  # ##### ## ##  ## #   # ##    ## ##
############# # ##      # ###     ##  ##### #  #######   ####  # #  # ## ###  ## ##  ########## ### ## ##  ####     ##    ##   ##    ##    #  ## #### #    ## # #####
### # ## ########  ### ## #   ###    #### ######       # ########## ###    #####  #### #### #        #  ##    ## ####  ## ### ### ##  # # ## #####    ## # #  #     #
#        # # #    ##   ## ### ##### ##  # ## ######### #    ### #   #   # #### # ##         ###### # # ##  # ### ## ## #   ## #    # #### ##    #### ### # #### ## ##
# # ## #       ##  ## ##### # #      ##         # ###  ## #       # ## ## ##     ## ####### # #    # ##### ###   #     # # #  # # ##    # ## ##  ##    #####     ####
# ###  ## ## #  ######## #    #### # ### # #### # # ##### ## ### ## ##  #  ### #  # #           # ##   ##    ####### # ###### # #  ## #####  ### ### #  ##   # #    #
###   ### #  ## ##         # ##    ### # # #               ##### ## ##### #### # #### #### # ## #  # #  ## ###       # ## #   # # ###     ##   ###   ##  ## ## # ####
### ### #### ## #  ####### #######  ##   # ######## # # # ##     #      # ## ############### #  ## # # ##   ##### #### ##   # # #   # # #  ## ##### ##  ##  ## #    #
# #####  # ###  ## #        # ##   ##  ##### #      ##### #### # ## # ###### ##  ## #     #  ##  ### # ## #  ##    ###  ## ## #### #######  #     ##### ## ##  # ####
# ##    ## ####### ##### # ##    ######## ##   ## #  ##    ##  # ## # ## ##     ##  ##### ##  ##  ## ###  ##  ## ###   #####    ##   # #### ### #   ##  #  ## ##   ##
# ##### ## # # # ###   # ###### ##           #  ####  # # ###### #  # ##    # #  ## ##     # ####  #   ####  ### ##  #  ##   ## #  #    ##    # ###  ## # ##  ## #  #
#        # # # # ##  #     ##    # ### # # # ## ##   #### #  ### ## ####### ####       ###   # #  ## #    ## ##   ## # ##  # ## # ## # #### ###  ## ##  # ## ### ## #
## ### #            #### # ### # ##### # # #  ###  #    ### ##   ##   # ###### ## # ##   ###   ##  # # ##  ##### ##  # #  ## ## #### #  ##    # ##  ## ####    #  ###
#  #   ## ### # ## ## ## #  ## ##### # ### # ##   ### # ##     #  ## ##           #### ###### ##  ## ##### #     ## ##### ## #     ### ### ########  # #    ## ##  ##
## #####  #   ###  ##    # #####        ## #  ### ##  ###  # # # ###  ## # ### # ##     ##     ##  #    ## ## # ##   ##   ## ### ###     #       ## #### # ##   ##  #
####     ## #   ## ## ## #  ##   # ## # #  ## # #  ## #### # # #   ####### #   #  ### # #  ###  ## # ##### #### #### ## # ##  ##   ## # #### #####   ##  # #  # ## ##
# #  ######### ### ## #  ####  # ###  # ##  ### ##  ###  ### # ## ##       ## ## #### # ## #   ### #  ## #  ###   ## #  # #  ##  # ## # # ##   #### #### # ## ###   #
# ####### ##   # # ##### ## ######### #  ######    ##### #   # ## #  ### # ## ## ##   #### ### ##  # ##    ##   # ## # ##### ### # #  # #  ## ## #####   ####   # # #
# ###        # #    ##   #    # ##    ####  #   # ### ## ## ## ## ## #   #  ######### ##   ##  ### #  # # #### ##  ### ##     ## #### #   ##       # #####    # # # #
#     # # # ## # # #### ### #    #### #  ##   # # ##        ## ##  ##### # ##   ## ## #  #  ##   #### ### ##    # ##    #### ###  ##### ##### ####     ##  # #### # #
#### ## ### ## # # ## ####  ## #      ##    # # ##### ## # ##   ######   # ####       # ###### ###     ##  ## # #  ### ##      ##  ##       #    # # #### ##    ### #
#    #  #    ### # ##      ######### ### ## # #  ##   #  #  ## ##      # # #    # ### # # ###   ## # #  ##  ### #####   # # # #### #### ##### ## # #    ###  ###### #
####### # # #### ####### ####   ####   # #  #### ####### # ##  ### # # # ##### ## #   ### # # #  ###### ## ##    ##   ##### #### # #      ###### # # ##   ##      ###
# # ##  # ###     ##      ##  #      # #######   #       # #  ##   # # # #     ## # # ###     ##  ##    ##  ## #  ## ## ##  ## # # # ## # #    # # #  # # #  ### ####
#      ##  ## # # ## # # #### ## # # # ## ## ### #### ## ### ##  # # # # # ## ### # ### # ## ##  ### # ##  ##### ##  #   ##      # #  ###   # ###### #######  ##    #
# # # ##  ##### # #  # # #  ###### # # #      ## ##   #  #    ###### # # ###### # # #      # ## ##   # ### # #####  ####    # # ## # ##   ###    ##   ## #   ###### #
# # #  ##  ##   # ## # #   ##      # # ## # #    ## # ## ## # ##     # # #        # ## # # # ##  ## ## #        ## ##    # ## # ## # #  #   # ##  ## ##    #     ## #
################################################################################################################################################################### #
