# ########################################################################################
#          ## #   ## # ## ##    #  ## ##  ## # # #  ##   ## #  ## #     # ## # #  # # # ##
#### # #####  ## ###    # #  #### ##   ##  # # # ## #### #    ##  # # #      # # ## # #  #
######   ##  ##    #### # ## # #   ###  # ## #   ##  # # # ##### ###########     ## # # ##
#   #  ##### ### ###    # #      ### ## #    ### #  ##      ###  # ##        #####  # # ##
### ##  #### # #   ####   ### ## # #  #   ####   ## ##### ### ##   ### ### #   ##  ##    #
# # ###  ##      ### #### #   ## # ## # # #  ### ##  ##   # # #  #   ####### ###  #### ###
# #  ## ####### ## # # #    # #  # ##   # # ## # ## ##### # # # ######    #      ## ## # #
# ##  # ##       # # # ## ###### # ## # # # #  #     ## #     #   #  ####   # ##### #    #
# ### #  ##### # # # #  ###  #     ## ##### ## # ### ## ### ### ### ##  ##### ### # ## ###
#  ## ## # ##### #   # #####   ### ##   ##     ####   # #    ##      ## #     # # # #    #
## #  ##   # #   ###      ### ## # #  ########  # ###   ## ##### #####  ##### # # # # ####
## ##  ### # ###   ### #### ###      ## #### ## #   ## ##  # ##  ##  ## #  ## # # #    # #
#   ##   # #   ### # # # ##   ##### ##   # #  # ###  # #  ##  ##  # ##  # ##  # # ## ### #
# #  ## ##   # # # #   # ## ### #      ### ## # # ## # ## ## #### # ### # ### # # ##     #
#### ## ###### #   ### # ## # # ### ####   ## # # ##   #      ##     ##   #   #   ## ## ##
#          ### ## ##   # ##     # # # ## ###       ### ### ####### ###### ### # ###  #####
####### #### #  #  ### #  #####          # #### #### # ##  ### #   ## # # # # # ##  ## ###
# ## #  # #  ##   ## # # ##   ### ######## # #   ##     ## # # ### ##   # # #   ## ###  ##
#    ## # # ##### ##      ###   #  # ## ##   ### #### #### # #  ##  ## ## # ## ##    ##  #
####    # # ##     ##### ## ### # ##     ### ### # #  ##     # ### ##  ## # #   ## ###  ##
#    ## #   ##### ##   # ##     # #  #######     # ##  #####   ##   ## ##   ###  #  ## ###
####### # ###   #  ###   ## # #     #### # #####    # ## # ## #### ###  ### ####   ##   ##
## ###  # # ###   ## ### ###### # # ##      ## #### # ## #  # # #   #  ## # # ####  # #  #
#    ##   # # ## ##  ###    #######  ### ##### # ## #  # # ##   ### # ### #    ##  ## ####
####    #   # ## #  ## # # ##  # ## ## # ##  #   ## ##     ## ### #   # # ### ### ##   # #
#    # ####   #  ## ## # #  ##      ##    ## ### #  ###### #   ##   ###    ## ##  ### ## #
############ ## ##       ######## #  ####    ##  ##  ## #    ###### # ### ###  ##  #   # #
## ## ### #   #  ##### #  #  #######  ######  ## ## ##  #### # ## #   ##  # ##  ## # ### #
#   #  #    #   ### ##### # ##   # ## # ##   ##  ##  ## ## #   ##   ##### # #  ### # # # #
### ##   ###### # # # ##    ####    #    ### ###  ## #  ## ## #### ##  ## #   ##   # # # #
#   ###### ## # # # # ##### # #  ## # #### #   ## ## ## ##     ##   ##    ###  ### # #   #
###           #   # # #     # ## #    ## # ### ##  # #   #### #####  #### # ## ##    # ###
### # ##### #   # # # #####   #######  # #  #     ## ## ### #  ## ##  ##    #  ## ####   #
#   ### # #### ##   # # ##### # ## ###   ## ##### ## #  ##  # ##   ##  ####   ##   # # ###
## ##   #      ## #   # # ##  # ## # # ###        #    ####   ### ##  ## ####  # ### # ###
#  ####   # # #######      ## #         ### # ### # # ### ###  #  ###  #  # ##       #   #
# ## ### ######  #### # ## #    # ##### # ##### # # ###   # ## ##  ## ## ## ## ### #   # #
# #       ######  #   ###    #######    # ## #  # #  ####         ### ## ##     ##### ####
###### # ## # ###   # #### # ### # ####   ## ## # # ##  #### ## # # #  # ###### # # ### ##
###########       # # #  #####       #  #  # #      ## ## ####### #   ##  # ##       #   #
# #         # ## #### ##       #####   ###     # ##    ##  ## ##  ###  ## # #  # # #   ###
#   # #### ## #### ###### #### ##    ####  ### #  ## #    ##   ## # # ##      ###### ### #
### ###    #  #        ## ##   ## # ##    ############ ##  ### #  # #  #### ### # #####  #
######  ## ########### ####  #  ######### #  ## # # ###### ##  ## # # ## ##       #   # ##
# ###  ######## ## ### #  #######         ##         ## ## ### #          # ### #   #   ##
# #   ## ###     # #   # ###  #   ## # ## #  ####### #  ## # # # ##### ##     #### ####  #
# #####  # #####   ### # # ## ########  ######## #   ##          ##     ## ######### ### #
# # ####     #   #     # # ## # ## ####### ##    ### #### ## ## ###### ######## # #   ## #
#        ### ### ##### # # ##         ##   #####      # ######### ###     ##  # #   ######
# ## #####       #####      ######### ####       ## # #  # ## ### # # # #  ## # # ### # ##
####### ######## #   ## # #  ##   ##   ##  #### ##### ## # #  # # # # ######  #     #    #
#####    ##### #####  ######  ###  ### #  ##    ##         ## #        # # ##   # #   ####
# ##  ##        # #  ######## # ##       ##  # #### # # ##      ###### #    ## #### ### ##
#  ##### ######   ##  # # # # # #### ###  # #####   ### #  ## ###        ##     ###      #
## # # ##########    ##   # # # # ####   ####   ## ####### #   ### ## ##  ## #### ########
#       ##        ##  ###          ##  # # ####    ##  # # # # #   ##  ##  #       #     #
###### ###### ## ##  ## ###### # #    ##   # ## ###### #   # ##### ## ##  ### ###### #####
#       ## #########           # ## #  ## ##    #        # # #      #### ## #            #
####### ## # # ## #  ## ## # # # ## ## ##  ## # #### ## ## ##### ##  ##     # # # # #### #
#  #         # #  # ##  #  # ### #   #####  #####    #   #####   ## #### ## # #####    ###
##   #######   ##    ## ## ####  # ####    ###    ## # # ##    # ##   ##  # #### #####   #
#########    #    ##########    ## #  ## ####  # ##  # ######### ## # ## ##       ## #####
# # ##    ##### #    # ## #  # ######    #    ## #####  ##        # # ## ## ### #     # ##
#   #  # ##     ## ###      ## ## # # # ### # #  #     ##  # # ## ### ## ##  ## # # #    #
###   ####### # ##  ## # ##  ###      ###   #### # # # ### # # #    # ## #  ##  # # ## ###
##  # # # ##### ## ##  # ## ##   # ## #######  ##### ###   ### # # ## ##### ## #######   #
#  ## #         ##  # ## #  ## # ###  #     ## ## ##   ## #### # # ##   ##  ## # ##    # #
# ##  ## ##### ##  ####  ## ## # #   ##### ##        #######   # # ## #####  #    ## # ###
#  ## #  #     ###    ## ## #  ##### ##     ###### # ### # ## ## # ##  # #  ## # ##  #####
# ### ## #####   # # ######### ##    #### #        # #         # # ## ##   ### #####     #
# # ######     # # ### ### #   ##### # #  ####### ###### ## ## # # ##  ## ###   ##   # # #
# #        # # # ###     # #####     #   ##       ##     #   ### # ## ##    ## #### ######
# # # # ## ### ####  # #      #### # ####### ######  # ### # ##  #  #  ### #####         #
########## ##  ## ## ### ## # # ######       ##     ##   ### ##### #####   ##  # ## ## # #
## # ##    ### #     ##  ## #       ## ### #  ##### ## ####      #  ###  #    ## #   ### #
#  #    ##   ### # # ### ##### ## #     #### ###    ##  ##  ## # ####   ### # ## ###  ####
##   # ##  ##### # # #    ######  ### # #    # ####  ##  ## ## # ###  #  ## # ## ### ## ##
### ## ### ##    # # # # ## # ### ### ########      ##  ### #  #   ## # ##### ## #       #
#   ## #    #### # ### ####       #   #####    ### #### #   ## # #  ###    ######### ## ##
## ##  ### ##    #   # #    ## ## # # # # # ## #   ## # ### ## #### ##  ##   ##      #   #
#   ## #   #  ## # ######## #   #######     #  ## ###   #   #   ##  ## ##  ###  ## #### ##
### #  # # ## ## # #  # #   #####  ##   ### # ###   ## ### ### ### ##   ##   ## ## #  #  #
#   ######  ###  ####   ########## #  # #   ####  ###   ####     # ### #### ##   ####   ##
####### #####   #######            ########    ##   ## ##    ## ## # #  # ######    ### ##
##      # ##  #### # ### ####### #          ## #  ######## # ##  # #   ##  ##    # ##    #
#  # ##    ##### # #  #  # ## ###### # # # ##  ##     ##   # ### # ###    #### # # ## ## #
# ######## # #   # ##   ##      #    # ### ####### ##  ## #### #####   ####    # # ####  #
### # #        #      #### ## #   ## # #     ##    ## ##   ##   # ####    ## # # # # #  ##
#       ## ## ### # # ###  ## ## ### # ## # ######  # ## #  ###        # ### # ##### # ###
# ### # #  #   ########   #####  ##  ###  # #      ## ## # ###  ## ## ##   # # #         #
###   #### ### # # # ####### #  #### ##  #### ### ###  ### # ##  ###   # ############# ###
#### ##  ### ###     # #       ##    ### ##   #     # ##     ## ##### #####   ## ## #    #
#  #  ##      #  # #     #### #### # #    ######## ##  ## ##  ###         ###         ## #
##   ######## ###### ## ##       # ##### ###        ## #   ##   ## # ## #   ####### ###  #
### ##           ############ #######      #### ### ## # ###  # ## # ## ### ##        ## #
# ############# ## ## ## ##      ##   # #### ##  ####### ##  ## ## ###  ##  ## #### #### #
#    ## #####            #  # ####### ###     ##   ##     # ##   # #   ### ##  #       # #
# ##          # # # # ##   ##   ##    ##  # #    # ## # # #  ## ## # # #   #  ## # # # # #
######################################################################################## #
