# ##############################################################################################################################
#                  ##    # ##     ##  # ##  ##  ##  #  # # ##   ## #       # # #  ## #  ##    ##  # #    ## ##   # # # # ##    #
###### # # ## ## #    ## # ## ####### # #  ##  #### # ## # #  #### #######       ##  # ##  ###### # # # ##   ## ## # #    ## ###
# # ## ############# ##     #     ##    ##  ##  ##  # ##   # ####   # ##   ######### #  ## # # #    # ##### ##  ## # # ####  ###
#      #     ## # ######## ## #########  ##    #### #    ### #  ### #  ###     ##      ### #   ## ### ## #   ##  # #      ## # #
############ ##        #   ## # ## #    ######  ##  ## ### #   ## # ## # # ###### # ##   # # #### # # #  ###  ## # # ######    #
#    ##  #      ###### ## ##     # ## #  ##    #### ## ### # ###  #    # #      ######## #   ##         ## ## #      #    ### ##
#### ### ## ## ####     # ## ###    ### ###### #  # #    # #  ### ####   # ######  #       ###### #######     ## ##### ####    #
# #   ## ########   ### # #   ##### #          ## # # #### ## # #  ##### #      ## ##### #  ##  #     ###### ###  ##    # #### #
# ### ##  ### ##  ###   #   ### # ############ #  # #  ##   #   # ## #   # ######  ## ##### #  ## # ### ##       #### ###  ### #
#      # ## # ######### ## ##      ## ##   # # # ## # ##### # ###  # ### # ### #  ###  ## #   ##  # ###  ###### ###    ## ## # #
######   ##   #  ## ##     ## ######   ###              ##      ## # ##          ## ## #  ###  ## ### # ## ####   ### ### ##   #
# ## ### #### # ##   ##### ##  ## ## ### # ### # ## #####  ## ###    ## #### #####  ## ## ##  ##   #  # #  #  ### ##  ##     # #
# #  ###         ### # #    # ##   # #   ### # ###     ######   ### ##    ####  ## ##  #  ###  # ### ## ##   ####  ## ## #######
# # ## ######## ##       ## # ## ### ###  ##     ### ### ## # ###      ##    ## ## ###   ##   ## ##  ## #  ####   ##      # # ##
#   ## # ##      ###### ##    #  # #   ## #### ###    ##    #   ######  # ####  ##  ####  ###     ##  #   ##  ###    ## #      #
###       # ## #  # #########   ##   ###  # #### ## #  #### # ####  ## ####  ## ###   ## ## # ## ### ## #### ##### #### # # # ##
# ####### #######   # #####   #  ### # ## # # #  ##### ## # # # #  ##    ### #  # ## ### ## #  ####   #    # ##       #######  #
#     ##   # ## ### #   ##  ####     # #    # ##  ## # #  # #   # ##  ##  ## ## # #  ##  #  ##  ##  #   ####  #### ####   ### ##
### #  ###   ##  ##   ######## # ##### ## #    ## ## # ##     ### ## ######  ##     #### ## ## #### #####  # ## #     ## ## ####
# #### # ###  ##  ## ### # #      ###  ## ### ### ## # ## # # #   ## ##   ## #  # ### ## ## ## ##    #  ## # #  # ######  #    #
# ##      ### ### ##   # # ##### ## ##  ####   #  ## # ## ###### ##   ### ## ## ### # #  ## ##  ####   ###   # ##      ## # ####
# ####### # #      ## ## # ##        ##  ##  #   ### # ##  # ##  ## #  ##  # #  ##  # # ##     ## ## ### ### # #  ### ###    # #
# # ##  # # ### ## ##  # #  ##### ######  ##### ## # #  ## # #  ######  ##   ## ### # #  ## ####     ###       # ## ####  #### #
# # ###       # #  ## ##   ##  ##    # ## ##    ##     ### # # ## #  ##  ## ##          ##    ## ##### #### ##   ##  # ##      #
#   # # # ## #####     # #  # ##  ####     #### ###### ##         ##    ### ######## # ##  ## ## ## ##   ####  # ## ## ## ######
###   ###  ##### #### #####      ##  #####  # #  # ### #  # ## ########       ###    #  ## #####    ## ### #  ##### ##  # # # ##
### ####  ### #        ##   #### ## ##   ## # ## # # #   ##### # ##     ####### ### #####   ## ## ###  # #   ## #   ### # #    #
# #  ##  ##   ########  ######   ##  ### ##   ## # # ## ## # ###  ## # #### ##       ##   ###  #   ## ## ## ###   #  #  #   ####
# ##  # #### ## # # ## ##  # ### ## ## # #  ####   # #       ##  #####    # ##### # ##### # ## ## ##  ## #    ###### ##   #### #
#  ##   # #  ##   # #  ###   # #  # #  # ##  # ### # ## ######## # ##  # ## #  #### # # # #  # ##  ##  # # ####  ##  ## ###  # #
# #### ## ##  ###   ## # ### # ##   ##   #  ## ##         ## # # # #  ####    ## #    # #   ## ## ### ##    # ##  ## #  # ## # #
#   ## #  ###   ## ##     #       ######   ##  #### ## ####  # #   ## # #  ####    ##     # #  ## # # ## ##    # ##  # ## #  # #
# ###    ##   #       # #   # ### ## # ###  ##  # ####    ##     ###      ### ## ###  # ###### ## #       # # ##  ## # ## ##   #
# # ## ###### ## ### ###### ###        # # ####    ##  ####  ### # ### #####   ######## #   ## ## # ############ ##  #  # ### ##
# # ## #  ### ########   ## #   ## # #      ##  ##  ## ## ######   ##    # # ###   # #  # ###  ## #  ##   ## # #  ##   ## # # ##
# # #  # ## ### ##  ####  ### ###  # ###### ## ######      ### ### ## ####   # ###   ##     ## #    ### ####   # ##### #  # #  #
# # ##    #  ##  ##  ####   ####  ## ##     ##  # # # ######    ## ##  ##  ### # ###    ## ###   ## ##   ##  #    ##     ## # ##
# #  ### ## ####  ##      #### # ##  #  # #    ## # #      ### ##   ##  ## ###    #  ########  ######  # ### ######### #  #    #
# # ##        ### #######   #     ## ######## ###     # ## # #  ## ##  ###   #### ##   ## ##  ## #  # ## #   ## #   ##### # ####
# #  ### ######    ## # ###   # ###### ##       ### ###### # # ##   ## # ### ##    ## ###  ##  #   ## ###### #    ### # #    # #
# # ##       ## ##    # ########### #   ###### ##      # ### #  ## ##     #   ### ##    ##  # ## ###   ## ##   ## ##  # ## ### #
# # ### #########  ##   # ##   ## # ### # # ##  ## ##### ##  # ##  ### # ## ####   ### ####   ## # # ###  #  # ######   ## #   #
#    #        ##  ##### # #### ##              ###    ##  ## # ### # ### #   ##  #  ##  # ### ## # # # ## # ##   ## # # #  # ###
#### # ######### ### ## # # #   #### ## # # ##  #  ##### ##  #  ## # ##  # ########  # ## # #               ####### ### ## #   #
#  # #  #### # ####           #  # ############ # ####    ## # ##     ##   ## # # ## # ## #   ########## ##  ####   ##  ## # ###
## # # ##  # # ## ## ###### #### # ## ## ##   #      ## #### #  #### ### #### # #    # #    #          # #####  # #  ## #    # #
#       ## #   ## ##### ###### # # ## ##  ### ### ####   ##  # ## #   #   # # #   ####   #### ## # # ##### # # #### ##    ##   #
#### ####  # ###   ## # # ## # # # #   ##  #  ### ## ###  ## # ## ### # ###   ###  # ### ###########  # ## # # # #   ### ### # #
#     # ## # ##  ###      #  # # # ###  ## ##   # #  ##  ##  # #   #     #### #   ##  ##    ### #  #### ##   # # ### #   # #####
### #   ##    ##   ###### ##   # # # ## ## ####   # ##  ####   ###   ## ## #  ### ## ##  #### # # ####  ### ##   ###   # # ## ##
##### ##### ###  ###  ### ####     # ##  #  ##### #  ## #  ###  ### #####  ## #    #  ##  # # # #  # ##  ##  ## ## ##### #  #  #
#  #  # ##  # ##   ## # #    ## ##    ## ## # #     ##    ## ##  ##    ## ##  ####   ##  ##   # # ##  ##  # ###  #   ##  # ## ##
## ##    # ##  ###      #### ####  ##       # #####  ### ##  ## ##  ## ## #  ## ### #### ## ### # ## ##  ## # ##   #####   ##  #
#     ## #  ##  ####### # ## # ###  ## ## # #    ## ##   ## ##  #  ###### ## ##  ## ## #     ## # ## ###      ## # # # ## ##  ##
#####  # # ### ##  ###  # #      ##  ######   ##       ####  ##   ### ##  ##  # ##   # # ######   ##  #  ######  ### # ##    ###
# # # #### # # #  ## ## # ### # #######     # ########    ##    # #    # ##  ##    ### #   ## # ###  ## ## ## ##  ##   #  ##   #
#      ##  # # # ##  #  #  ####  # ## ### # # #      ####  #### ##### ##  ##  ### ##     #### # # # ### ## ## #  ##### # #######
# ## #  ##     #  ## ## # ## #  ## ## # ######## # # #  ##  ##   # #   ##  ##     ## ###### #           ##  # # ## # # # ## ## #
# #####  #####   ##          ## ## ## # ## ### ##### # ##  #### ## ## ####  ##### #  ###  # # #### ####### ##   ##             #
###     ## # # ##### # ### # ##  #  # # #   #   # #     ## # #     ##  # ##  ## # # ## ## #      # #    #   ## ###### # ### ####
####### ## #    # ######## ##### ##     ### ###     # #  #   ## # #### # ### ##      # #    ######## #### ###  ## # # ### ######
#  #     # # #### # # ##    ## # ## ##### # # ########## # ###### ##   # # # ##### ### # ## ### # #  #    # ## ## #    #   #   #
## ##### # #  ##    #  ### ##  # ##  # #  # #   #  # # # # ### #   ### # # # # # #  #     #   # # ## # #### #  ## # ##   #   ###
#            ######   ## #  ## #  ##   ## # ### ## # #       # ###  ## # # #       ## ######### # ## #  ##  ##  #   ###### #   #
### ####### ## #    ###    ##  # #### ### # # #      #######   ##  ##    # ## ### ### #### #  # # ##   #### ## ## ### # ########
##  #        # ### ## ####  ## #  ##  # # # # ######         #  # ##  ##    #   ####       ##   # ## #  ##  #   #         #    #
#  ######### # ##  #    ###    # ##  ## #      ###   # ##### #### ######### # ###  # ######## ### ## ###### ## ## ## # ##   ####
# ## ######    ## ## ## # #### #  ## ## # #### # # ######     ##  # ##        # ##      # ##   ## ##  # ##  ##     # ###  #    #
# #         ##     # #### ##   # ##  ## ####   # # ###  #####  ## # ##### ## ##  ### ####  ###  #  ## # ###    #################
########### ## ###    ##   # #    ## #   # ### # ### ## #     ###   #  #####    ##   #  ## # # ## ##     ## # ### # ##  ## # # #
###   ###   ## #   ##    ######## #  ### # ##     #   # #####  #  # # ## #   # #####   ##  # # ##  ## ####  ###     #  ##  # # #
# ### # # #### # ####### # ## # # ## #   # ###### ### # #   ## # #### ##   ### # ##  #####   # #  ###  #### ##  # # # #### #   #
#   #   #### ### #  # #    #  # # ## ### #  ## ## ##    ###      # ##  ###  ## # ## ##  ## ###   ##   ##  #  # ###### # ## # ###
### ### ##    #####   #### ##         ##   ###    ##### # ##### ##  ## # ## #### ##  # ##  #   # ####  ## ## # # # #  # #      #
#   ##   ## ### ##### ## #  ######### #  ### ## # # ###          ## ## # #   ##  #  ##  ##   ##### ## ##  ##   #     ## # ######
# #  # ###   ##  # #       ## ## ##   ## ### #### # # ######### ##   # # ###  ##   ##  ### #### ## ## ## ##  ### ######     ####
####    #### ###     # ###          #    # #  ##  # # ## ##     ### ## #  ## #####  ## ##   # # ##  # ## ## ###   #  #  #####  #
## ####  ##   ##### ####   ### ## # ## #     ####     #  ### ##  #  ##   ###  ## ## #   # ### #  # ## ## ## # ## ## ## ## # # ##
#       #####  # ####  ##################### ##   ### ## # ##### # ##### # ## ## #  # #    ## # ## #  ## ## # #   #         # ##
# ## ##   ####    ##  ####   ######## # #    ## # #        ##      # #     ## ## # ## #######    # # ### #      ### ####### #  #
######## ##  #### ## ##  ### # ## #   # ####  ########### ####### ## # # # ##       #  ## #   ##       # # ######   ##   #### ##
#   #     ## ##       ## ###    # ### # #####  ##  #       ##   # ## ### ##### # #### ##  ###  #########    ##### #  # ### ##  #
# # ### #     #### ## ##   ### ## ##        ##  ## #### ##  ###    # ##   ## ###   ## ## ## ##  # ##  ### ###   ####   ##     ##
### # #### ##   #####  ## ##      ###### ###### ##    ###  ##   ##    ###  # ##  ###  ## ##  ##   ## ## # # ###  ##  #    # ####
##       ###### # # # ##  ###### ## #### ### #   ####  #  #### ##  # ##   ## #  ## # ##  ### #  ###   # #     # ##  ########## #
#  ### ######            ## ## #         # # ## ### ## ##  ##  #  ##  ### ## # ##    ###  ## ##     ### # #####    ## #    #   #
#####   ## #  # # ## ### #     ####### # # #    ##      # #########  ###        # #### # ### ## ###  ## # # # # #####   #### # #
# #   #  # ############# ##### # ### ### # # ##########   #  ####### # ##### ####  # # # ##  #  # ####           ## ## ## ## ###
# ###### # ### # #####    ###        ##       # ###   ###   ## #  #     ###    #  ## # # ### ## #  # ## ##########             #
# #### # # # #    ##   ##     # # ## #  #### ##  #  # ##  #### ## ##### # ## ### ##    #  ##    # ## ##      # # ## ## ## # ####
#              ##    # ### ## ### #    ##     ##   ######  ##      ## # # ##  ##  ## ### ###### #  # #  ######    # #######  # #
##### # ## ###  ## # # #    ###   # #########  ###   ## # ##### # ##    #  ##  ##    # #  ## #  # ##   ##  # ## #     ##  # ## #
##    # ##  ## ##  # ########### #######      ##   ###  # # # # ####### ## ## ##  #### # ##  ##      #  ##      # # #    ##    #
#  ## ###  ##   ## ####  #### #######    # ##  ### # ## # # #    ##     #  ##  ## # ## #  ## ### ######    # # ###### # ########
## ## #   ##### #  ##   ##      # # ######  ##          # # ### ####### # #### #     # # ##   ## # ##### # #####  ########     #
#  #  ###  ##   ## ## #    # ##            #### # # ### # #   #  ## ##  # ## #   #####   ####        # ###    ## ##  # # ### ###
## # ###  ##  ######### ## #  ## # # ### # #  ########      #   ##  ### # #  ###    #### # #  ## ###     # ##### ## ##    #    #
#  ###   ######## ## #  ## ####  #####   ####  # ### ## # #####  ## #   #   ## # ####        ##  ### ########    ##    #### ####
# ###### # #           ###### #####  ### ## ##    #   ######    ##  ### ### ##      ## #### ####   ######     ##### ##         #
# #        ###### # # ## #    # # # ## ###  ##### ## ##    ####  ## # # # #  ## ######    #  ##  ####     ##### ##   #### # # ##
# # # ## # # # #########   ##           ## ##      # ## ## #    ### # # # # ###   # #  # #########    ##### ##   # #############
# ##########       #   ####### ##### ##  # ##### #   ##### #### ##            # ###   #### ## ###  #### ###  # ### #      ## # #
#####     #  ### # ### # ## ###### #####      ###### # ##        ########## ###     #         # # ## #      ## # #   ## #      #
### ##### ##  #### #   # ## # #     #  ### ##   # ## #  ## #### ## ###  #   #### ##### ### #### #      #######     # ##### # # #
#      #     ## #    #        ##### ## # ###### # ## ##    #       # ## ###   ##  ###### #### # # ######       ## #### # #######
# ## #   # ###    # ### #### ##          ### ##    # ######## ####          ###  ## # ##  # # #          ## #######          ###
# #  ########### ##  ####    ###########      ####   # # ######  ########## # # ##       ##     ### ######     # ## ########   #
### ###   #   ## #  ##    ##    ###      # ##  # ### # # # # ### # ## ###   #      ## ## #  # #   ####   ## ##           ##### #
### # ###   #    ############# ##   ## # #  ##                            #   ############ ######### # ########### #####     # #
# ###  ######## ##   #  ##        #### # # #### # ## # ##### # # # ## ## ####   ## # #  ## # # ##               ########## #####
#  ###       #######   ##  # ### ##    # ### #  ###  ####    # ### ####### #  #    #   ### # # ## #### # # # ##          #     #
# ## ### # #   # #####    #####   #### # ##  ####### ##   ## ###   # #     ## ####   # #        # ## ########## # # ############
#  #  #  # # #   #     ## #   #####    ##### #### ## ######  #######   # #       ## ##   # # ##       # # # # #####            #
## ##   ######## ##### #  # #       ##### #           ###   ## ############ # # ##  ## # # # ##### ##             ## # ###### ##
#     # ##             ######### ## #       ## #### ### ## ##      #### #   # # ### ###### #   ####### # # ## # #  # #  ########
# # ############ # # ###   #     ## ## ##############      #  # ##      ## ####  ##      ### #       # ### ####### # ####      #
#######    # ##### ####### #### ###  ###           #### ## ## #########      ## ### # ##  ## #########  ##    ########### #### #
##    ## #      ## #              ####   ####### #      ##  # ##        ## # ## # ###  ## ##     ###### ## #### # ####       # #
#  ## #########    ### ## ##### ####   # ## ###### # # ##  ## #  ##### ##  # #  # ### ### ## # ###    # #          # ## ### ####
# ##    #       ## #    #####   ## #######      #  # # #  ##  ##### ##  ## # ##     #   # ## #     #### # ###### #       #### ##
# #  ##   # ## ##  # ## ##    # ##         ## #   ## # ##  ## #        ##  # #  ## ### ## #  # # #    # #      # ## # ##       #
############################################################################################################################## #
