#.##############################################################################################################################
#..................##....#.##.....##..#.##..##..##..#..#.#.##...##.#.......#.#.#..## #  ##    ##  # #    ## ##   # # # # ##    #
###### # # ## ## #....##.#.##.#######.#.#..##..####.#.##.#.#..####.#######.......##  # ##  ###### # # # ##   ## ## # #    ## ###
# # ## ############# ##.....#.....##....##..##..##..#.##...#.####...#.##...######### #  ## # # #    # ##### ##  ## # # ####  ###
#      #.....##.#.########.##.#########..##....####.#....###.#..###.#..###.....##      ### #   ## ### ## #   ##  # #      ## # #
############.##........#...##.#.##.#....######..##..##.###.#...##.#.##.#.#.###### # ##   # # #### # # #  ###  ## # # ######    #
#....##..#......######.##.##.....#.##.#..##....####.##.###.#.###..#....#.#......######## #   ##         ## ## #      #    ### ##
####.###.##.##.####.....#.##.###....###.######.#..#.#....#.#..###.####...#.######..#       ###### #######     ## ##### ####    #
#.#...##.########...###.#.#...#####.#..........##.#.#.####.##.#.#..#####.#......##.##### #  ##  #     ###### ###  ##    # #### #
#.###.##..###.##..###...#...###.#.############.#..#.#..##...#...#.##.#...#.######..## ##### #  ## # ### ##       #### ###  ### #
#......#.##.#.#########.##.##......##.##...#.#.#.##.#.#####.#.###..#.###.#.###.#..###  ## #   ##  # ###  ###### ###    ## ## # #
######...##...#..##.##.....##.######...###..............##......##.#.##..........## ## #  ###  ## ### # ## ####   ### ### ##   #
#.##.###.####.#.##...#####.##..##.##.###.#.###.#.##.#####..##.###....##.####.#####  ## ## ##  ##   #  # #  #  ### ##  ##     # #
#.#..###.........###.#.#....#.##...#.#...###.#.###.....######...###.##....####  ## ##  #  ###  # ### ## ##   ####  ## ## #######
#.#.##.########.##.......##.#.##.###.###..##.....###.###.##.#.###......##....## ## ###   ##   ## ##  ## #  ####   ##      # # ##
#...##.#.##......######.##....#..#.#...##.####.###....##....#...######..#.####  ##  ####  ###     ##  #   ##  ###    ## #      #
###.......#.##.#..#.#########...##...###..#.####.##.#..####.#.####..##.####..## ###   ## ## # ## ### ## #### ##### #### # # # ##
#.#######.#######...#.#####   #..###.#.##.#.#.#..#####.##.#.#.#.#..##....###.#  # ## ### ## #  ####   #    # ##       #######  #
#.....##...#.##.###.#...##  ####.....#.#....#.##..##.#.#..#.#...#.##..##..##.## # #  ##  #  ##  ##  #   ####  #### ####   ### ##
###.#..###...##..##...########.#.#####.##.#....##.##.#.##.....###.##.######..##     #### ## ## #### #####  # ## #     ## ## ####
#.####.#.###..##..##.###.#.#......###..##.###.###.##.#.##.#.#.#...##.##...##.#  # ### ## ## ## ##    #  ## # #  # ######  #    #
#.##......###.###.##...#.#.#####.##.##..####...#..##.#.##.######.##...###.##.## ### # #  ## ##  ####   ###   # ##      ## # ####
#.#######.#.#......##.##.#.##........##..##..#...###.#.##..#.##..##.#..##..#.#  ##  # # ##     ## ## ### ### # #  ### ###    # #
#.#.##..#.#.###.##.##..#.#..#####.######..#####.##.#.#..##.#.#..######..##...## ### # #  ## ####     ###       # ## ####  #### #
#.#.###.......#.#..##.##...##..##....#.##.##....##.....###.#.#.##.#..##..##.##          ##    ## ##### #### ##   ##  # ##      #
#...#.#.#.##.#####.....#.#..#.##..####.....####.######.##.........##....###.######## # ##  ## ## ## ##   ####  # ## ## ## ######
###...###..#####.####.#####......##..#####..#.#..#.###.#..#.##.########.......###    #  ## #####    ## ### #  ##### ##  # # # ##
###.####..###.#........##...####.##.##...##.#.##.#.#.#...#####.#.##.....####### ### #####   ## ## ###  # #   ## #   ### # #    #
#.#..##..##...########..######...##..###.##...##.#.#.##.##.#.###..##.#.####.##       ##   ###  #   ## ## ## ###   #  #  #   ####
#.##..#.####.##.#.#.##.##..#.###.##.##.#.#..####...#.#.......##..#####....#.##### # ##### # ## ## ##  ## #    ###### ##   #### #
#..##...#.#..##...#.#..###...#.#..#.#..#.##..#.###.#.##.########.#.##..#.##.#..#### # # # #  # ##  ##  # # ####  ##  ## ###  # #
#.####.##.##..###...##.#.###.#.##...##...#..##.##.........##.#.#.#.#..####....## #    # #   ## ## ### ##    # ##  ## #  # ## # #
#...##.#..###...##.##.....#.......######...##..####.##.####..#.#...##.#.#..####    ##     # #  ## # # ## ##    # ##  # ## #  # #
#.###....##...#.......#.#...#.###.##.#.###..##..#.####....##.....###......###.## ###  # ###### ## #       # # ##  ## # ## ##   #
#.#.##.######.##.###.######.###........#.#.####....##..####..###.#.###.#####...######## #   ## ## # ############ ##  #  # ### ##
#.#.##.#..###.########   ##.#...## # #......##..##..##.##.######...##....#.#.###   # #  # ###  ## #  ##   ## # #  ##   ## # # ##
#.#.#..#.##.###.##  ####  ###.###  # ######.##.######......###.###.##.####...# ###   ##     ## #    ### ####   # ##### #  # #  #
#.#.##....#..##..##  ####   ####  ## ##.....##..#.#.#.######....##.##..##..### # ###    ## ###   ## ##   ##  #    ##     ## # ##
#.#..###.##.####..##      #### # ##  #..#.#....##.#.#......###.##...##..##.###    #  ########  ######  # ### ######### #  #    #
#.#.##........###.#######   #     ## ########.###.....#.##.#.#..##.##..###...#### ##   ## ##  ## #  # ## #   ## #   ##### # ####
#.#..###.######....##.#.###   # ######.##.......###.######.#.#.##...##.#.###.##    ## ###  ##  #   ## ###### #    ### # #    # #
#.#.##.......##.##....#.###########.#...######.##......#.###.#..##.##.....#...### ##    ##  # ## ###   ## ##   ## ##  # ## ### #
#.#.###.#########..##...#.##...##.#.###.#.#.##..##.#####.##..#.##..###.#.##.####   ### ####   ## # # ###  #  # ######   ## #   #
#....#........##..#####.#.####.##..............###....##..##.#.###.#.###.#...##  #  ##  # ### ## # # # ## # ##   ## # # #  # ###
####.#.#########.###.##.#.#.#...####.##.#.#.##..#..#####.##..#..##.#.##..#.########  # ## # #               ####### ### ## #   #
#..#.#..####.#.####...........#..#.############.#.####....##.#.##.....##...## # # ## # ## #   ########## ##  ####   ##  ## # ###
##.#.#.##..#.#.##.##.######.####.#.##.##.##...#......##.####.#..####.###.#### # #    # #    #          # #####  # #  ## #    # #
#.......##.#...##.#####.######.#.#.##.##..###.###.####...##..#.##.#...#...# # #   ####   #### ## # # ##### # # #### ##    ##   #
####.####..#.###...##.#.#.##.#.#.#.#...##..#..###.##.###..##.#.##.###.#.###   ###  # ### ###########  # ## # # # #   ### ### # #
#.....#.##.#.##..###......#..#.#.#.###..##.##...#.#..##..##..#.#...#.....#### #   ##  ##    ### #  #### ##   # # ### #   # #####
###.#...##....##...######.##...#.#.#.##.##.####...#.##..####...###...##.## #  ### ## ##  #### # # ####  ### ##   ###   # # ## ##
#####.#####.###..###..###.####.....#.##..#..#####.#..##.#..###..###.#####  ## #    #  ##  # # # #  # ##  ##  ## ## ##### #  #  #
#..#..#.##..#.##...##.#.#....##.##....##.##.#.#.....##....##.##..##....## ##  ####   ##  ##   # # ##  ##  # ###  #   ##  # ## ##
##.##....#.##..###......####.####..##.......#.#####..###.##..##.##..##.## #  ## ### #### ## ### # ## ##  ## # ##   #####   ##  #
#.....##.#..##..#######.#.##.#.###..##.##.#.#....##.##...##.##..#..###### ## ##  ## ## #     ## # ## ###      ## # # # ## ##  ##
#####..#.#.###.##..###..#.#......##..######...##.......####..##...###.##  ##  # ##   # # ######   ##  #  ######  ### # ##    ###
#.#.#.####.#.#.#..##.##.#.###.#.#######.....#.########....##....#.#....# ##  ##    ### #   ## # ###  ## ## ## ##  ##   #  ##   #
#......##..#.#.#.##..#..#..####..#.##.###.#.#.#......####..####.#####.##  ##  ### ##     #### # # # ### ## ## #  ##### # #######
#.##.#..##.....#..##.##.#.##.#..##.##.#.########.#.#.#..##..##...#.#...##  ##     ## ###### #           ##  # # ## # # # ## ## #
#.#####..#####...##..........##.##.##.#.##.###.#####.#.##..####.##.##.####  ##### #  ###  # # #### ####### ##   ##             #
###.....##.#.#.#####.#.###.#.##..#..#.#.#...#...#.#.....##.#.#.....##..#.##  ## # # ## ## #      # #    #   ## ###### # ### ####
#######.##.#....#.########.#####.##.....###.###.....#.#..#...##.#.####.#.### ##      # #    ######## #### ###  ## # # ### ######
#..#.....#.#.####.#.#.##....##.#.##.#####.#.#.##########.#.######.##...#.#.# ##### ### # ## ###.#.#  #    # ## ## #    #   #   #
##.#####.#.#..##....#..###.##..#.##..#.#..#.#...#..#.#.#.#.###.#...###.#.#.# # # #  #     #   #.#.## # #### #  ## # ##   #   ###
#............######...##.#..##.#..##...##.#.###.##.#.#.......#.###..##.#.#.#       ## #########.#.## #  ##  ##  #   ###### #   #
###.#######.##.#....###....##..#.####.###.#.#.#......#######...##..##....#.## ### ### #### #..#.#.##   #### ## ## ### # ########
##..#........#.###.##.####..##.#..##..#.#.#.#.######.........#..#.##..##....#   ####       ##...#.## #  ##  #   #         #    #
#..#########.#.##..#....###....#.##..##.#......###...#.#####.####.#########.# ###  # ########.###.## ###### ## ## ## # ##   ####
#.##.######....##.##.##.#.####.#..##.##.#.####.#.#.######.....##..#.## *,,,,, # ##      #.##...##.##  # ##  ##     # ###  #    #
#.#.........##.....#.####.##...#.##..##.####...#.#.###..#####..##.#.##### ##,##  ### ####..###..#..## # ###    #################
###########.##.###....##...#.#....##.#...#.###.#.###.##.#.....###...#..#####,   ##   #  ##.#.#.##.##     ## # ### # ##  ## # # #
###...###...##.#...##....########.#..###.#.##.....#...#.#####..#..#.#.## #,,,# #####   ##..#.#.##..## ####  ###     #  ##  # # #
#.###.#.#.####.#.#######.#.##.#.#.##.#...#.######.###.#.#...##.#.####.##  ,### # ##  #####...#.#..###  #### ##  # # # #### #   #
#...#...####.###.#..#.#....#..#.#.##.###.#..##.##.##....###......#.##..###,,## # ## ##..##.###...##   ##  #  # ###### # ## # ###
###.###.##....#####...####.##.........##...###....#####.#.#####.##..##.#.##,#### ##  #.##..#...#.####  ## ## # # # #  # #      #
#...##...##.###.#####.##.#..#########.#..###.##.#.#.###..........##.##.#.# ,,##  #  ##..##...##### ## ##  ##   #     ## # ######
#.#..#.###...##..#.#.......##.##.##...##.###.####.#.#.#########.##...#.#.###, ##   ##..###.#### ## ## ## ##  ### ######     ####
####....####.###.....#.###..........#....#.#..##..#.#.##.##.....###.##.#..##,#####  ##.##...# # ##  # ## ## ###   #  #  #####  #
##.####..##...#####.####...###.##.#.##.#.....####.....#..###.##..#..##...###,,##.## #...#.### #  # ## ## ## # ## ## ## ## # # ##
#.......#####..#.####..#####################.##...###.##.#.#####.#.#####.#.##,##.#  #.#....## # ## #  ## ## # #   #         # ##
#.##.##...####....##..####...########.#.#....##.#.#........##......#.#.....##,##.# ##.#######    # # ### #      ### ####### #  #
########.##..####.##.##..###.#.##.#...#.####..###########.#######.##.#.#.#.##,,,,   #..## #   ##       # # ######   ##   #### ##
#...#.....##.##.......##.###....#.###.#.#####..##..#.......##...#.##.###.##### #,####.##  ###  #########    ##### #  # ### ##  #
#.#.###.#.....####.##.##...###.##.##........##..##.####.##..###....#.##...##.###,  ##.## ## ##  # ##  ### ###   ####   ##     ##
###.#.####.##...#####..##.##......######.######.##....###..##...##....###..#.##,,###..## ##  ##   ## ## # # ###  ##  #    # ####
##.......######.#.#.#.##..######.##.####.###.#...####..#..####.##  #.##...##.#,,##.#.##  ### #  ###   # #     # ##  ########## #
#..###.######............##.##.#.........#.#.##.###.##.##..##..#  ##..###.##.#,##....###  ## ##     ### # #####    ## #    #   #
#####...##.#..#.#.##.###.#.....#######.#.#.#....##......#.#########..###....,,, #.####.# ### ## ###  ## # # # # #####   #### # #
#.#...#..#.#############.#####.#.###.###.#.#.##########...#..#######.#.#####,####..#.#.# ##  #  # ####           ## ## ## ## ###
#.######.#.###.#.#####....###........##.......#.###...###...##.#..#.....### ,  #..##.#.# ### ## #  # ## ##########             #
#.####.#.#.#.#....##...##.....#.#.##.#..####.##..#..#.##..####.##.#####.#.##,###.##....#  ##    # ## ##      # # ## ## ## # ####
#..............##....#.###.##.###.#....##.....##...######..##......##.#.#.##,,##..##.### ###### #  # #  ######    # #######  # #
#####.#.##.###..##.#.#.#....###...#.#########..###...##.#.#####.#.##....#..##, ##....# #  ## #  # ##   ##  # ## #     ##  # ## #
##....#.##..##.##..#.###########.#######......##...###..#.#.#.#.#######.##.##,##..#### # ##  ##      #  ##      # # #    ##    #
#..##.###..##...##.####..####.#######....#.##..###.#.##.#.#.#....##.....#..##,,##.#.## #  ## ### ######    # # ###### # ########
##.##.#...#####.#..##...##......#.#.######..##..........#.#.###.#######.#.####,#.....# # ##   ## # ##### # #####  ########     #
#..#..###..##...##.##.#....#.##............####.#.#.###.#.#...#..##.##..#.##.#,,,#####   ####        # ###    ## ##  # # ### ###
##.#.###..##..#########.##.#..##.#.#.###.#.#..########......#...##..###.#.#..###,   #### # #  ## ###     # ##### ## ##    #    #
#..###...########.##.#..##.####..#####...####..#.###.##.#.#####..##.#...#...##.#,####        ##  ### ########    ##    #### ####
#.######.#.#...........######.#####..###.##.##....#...######....##..###.###.##.,,   ## #### ####   ######     ##### ##         #
#.#........######.#.#.##.#....#.#.#.##.###..#####.##.##....####..##.#.#.#.#..##,######    #  ##  ####     ##### ##   #### # # ##
#.#.#.##.#.#.#.#########...##...........##.##......#.##.##.#....###.#.#.#.#.###,  # #  # #########    ##### ##   # #############
#.##########.......#...#######.#####.##..#.#####.#...#####.####.##............#,###   #### ## ###  #### ###  # ### #      ## # #
#####.....#..###.#.###.#.##.######.#####......######.#.##........##########.###,,   #         # # ## #      ## # #   ## #      #
###.#####.##..####.#...#.##.#.#.....#..###.##...#.##.#..##.####.##.###..#...####,##### ### #### #      #######     # ##### # # #
#......#.....##.#....#........#####.##.#.######.#.##.##....#.......#.##.###...##, ###### #### # # ######       ## #### # #######
#.##.#...#.###....#.###.####.##..........###.##....#.########.####..........###,,## # ##  # # #          ## #######          ###
#.#..###########.##..####....###########......####...#.#.######..##########.#.#,##       ##     ### ######     # ## ########   #
###.###...#...##.#..##....##....###......#.##..#.###.#.#.#.#.###.#.##.###...#,,,   ## ## #  # #   ####   ## ##           ##### #
###.#.###...#....#############.##...##.#.#..##............................#..,############ ######### # ########### #####     # #
#.###..########.##...#..##........####.#.#.####.#.##.#.#####.#.#.#.##.##.####,,,## # #  ## # # ##               ########## #####
#..###.......#######...##..#.###.##....#.###.#..###..####....#.###.####### #  #,,,,#,,,### # # ## #### # # # ##          #     #
#.##.###.#.#...#.#####....#####...####.#.##..#######.##...##.###...# #     ## ####,,,#,#,,,,,,,,# ## ########## # # ############
#..#..#..#.#.#...#.....##.#...#####....#####.####.##.######..#######   # #       ## ##,,,# # ##,,,,,,,# # # # #####            #
##.##...########.#####.#..#.#.......#####.#...........###...## ############ # # ##  ## # # # ##### ##,,,,,,       ## # ###### ##
#.....#.##.............#########.##.#.......##.####.###.##.##      #### #   # # ### ###### #   ####### # #,## # #  # #  ########
#.#.############.#.#.###...#.....##.##.##############......#  # ##      ## ####  ##      ### #       # ###,####### # ####      #
#######....#.#####.#######.####.###..###...........####.##.## #########      ## ### # ##  ## #########  ##,   ########### #### #
##....##.#......##.#..............####...#######.#......##..# ##        ## # ## # ###  ## ##     ###### ##,#### # ####       # #
#..##.#########....###.##.#####.####...#.##.######.#.#.##..## #  ##### ##  # #  # ### ### ## # ###    # # ,,,,,,,,,# ## ### ####
#.##....#.......##.#....#####...##.#######......#..#.#.#..##  ##### ##  ## # ##     #   # ## #     #### # ###### #,,,,,,,#### ##
#.#..##...#.##.##..#.##.##....#.##.........##.#...##.#.##..## #        ##  # #  ## ### ## #  # # #    # #      # ## # ##,,,,,,,#
##############################################################################################################################,#
