# #############################################################################################################################################
#   ## # ##   # ## ## # # ##  #  ##  # # ##    # # # ##   ##     #  ## # # ##       # ###  ##  ##     # # ### # ##     # # ##          ##     #
## ##  # #  ### #   # # # ### # #### # #  #### #      ## ### ##### ###     ## # ## ##  #  ##  ##### ### #  #     #####      ## ### ###  ## ####
#  #  ##   ####   #     #  #  #  # # # ##  ##  # #### #  # #   # # ##  ## ### ######## ## #  ######   # # ## ######### ####      # ######  # ##
## ##  ###  # ####### ### ## ## ## # # #  ####     ##### # # ### # #  ###  #   # ##    ## # ## ## # ###        # #     # ########### ## ##    #
#   ##   ## #           # ## #   # # # ## #### ###   ##       ##   # ## ## # ### ##### ##   ##  # #  ## ### #### #####   # ### # ##   # #  # ##
###  ## ### ##### ### ### ## ## ## # #  #  ##    ######## #####  #    # ####      # #  ### ### ## # ##  ### #    ##  ### #        ## ## # #####
# # ##  # #  ######   ##     #   # #   ## #### ####  ##     # # ### #    ##  # #### ##  ##  #  #       ## #### ##### #     ## # #          ## #
#   #  ## # ##      #  ##### ###     # ## # #  #  ##  ### ###     # ## ###  ## ## #    ####   ## ### ###   ##   ## #   ########### # # ###    #
###   ##  # ### ######  ##   # # ######## # ##   ### ##   # # ########## ##  ###  #### # #  ###    #######  # ###  ###    # ## ############# ##
# ###  ##   # ###    ## #### #    # # #     ## ### # #### # #     ## ###  ##  ## ## #  # ## ### ######   ##     ##  ## ##       ###       #####
#   ##  ## ##  ##### #   ##  # ##     ##### ## ##     ### # # #####    # #### #  #  ## # ## #     ## ## ### #####  ##   ## # ##  #  ## #### # #
# #####  # ## ##       ##### # ## ###### #   # #  #####   #    # ### ###   ## # ## ##    #  # #####   # ##   ## ## ## ##########   ###        #
# # #   ##  #  #######  ## # # ###### #  # ### ## #  #### # #### # #  ## ###  #  # ##### # ##     # ###  # ###  #              ## ## # # # # ##
# # ### ## ## ## # # # ##      #      ## # # # ## # ## #  # ##     ##  # # # ## ## # # # #    ##### # ## # # # ## ###### ### ####    ##########
#       ## ## ##       ### ##### ### ##  # # #  #      ## #    ###### ## #   ## #    # #   ## #  ## # #  # #       #   #   ###  ## ###  # # # #
# # # # ## ## ########     ##  #  ###### # # ##   # ####    ##     #  ## ## ##  ### ## # #######  #   ## # ## ###### #### ##### #### ## #     #
####### ##  # # #    #####  ##   ## ## # #   #  ###### ## ######## # ##      # ## #          # # ## ###              ####### ##   ## ## # #####
## # #  ## ## # ### ##     ##  ####  # # ### ##   ## # ##     ## ###  ### ## # ##   # # # # ##    # # #### # ## ### ## # ##  ## #  # #     ## #
#    ## ##      ##   ## ##  ##  # ## # # # #    #### # #  ## ##   ## ## ###  # ## ##### ######## ## # ## # ########       # ### #### # ###  # #
## #    ### # #  ###  #### ##  ## #  # # # # ##    #     ##   ## ##   #  ###   ## ######## # #   #          ## #  ## ######      ###     # ## #
#######  #### #### ## ##    # ### # ## # # #### #### ## #######   ## ## ##   ####   #  # # # ###   ###### # ## # ##### ##   ###### ### ###### #
# # # # ## ##  ##  ##  #### # # # #  # #    ##    #   # ##    ## ##   # #### # #  ### ## # # ##### # ## #####  #  # #   # ########  ## ## #   #
# # #    # ## ####    ## #      # # ## ## #### ##   ###### ## #  ## ### # ##   ##            # #   #    ##  ##   ## # ###  #     ## ##    # ###
#   ## #    # #  ####  # #### #        ##  #   ####   ##   ##### ##  ## # #  ##### ########### ### # ##### ##  ###     ## ## #####  ## ####   #
# ######## ## ##  ### ##  ######## ## #### # ### ######### # # # #  ### #   ### #      #  ###  # # #        ##   # #####       #### ## ## # ###
#  ## ##    # #  ## # #  ## ##      #### #   # # # #  # ## # # # ##   # ## ###  # ###### ## ## #     ########## ## ### # ####### ## #         #
# ### ### # # ## #    # ###  ######  # # # ###       ## ##   #   ## ### #    ##   # # ##    ## ### # ### ##  #       #   #   # # #    ### # # #
# ##   #### # ## ####     ##  # ### ## # # # ## ######   ### # ###    # ## # #  ###    # ##### # # ###    ##   ####### ### ###   ## ###########
#  # # # #  # ##    ### ##### #      #     #           ###         ## # ## ### ## # ##    # #        # # ##  #       #   #  ## ###  # # ## # ##
# #### # ##   ## ## ###  ##   #### #   ###   # # ####### ##### ######## #   ## ##    ####   # #### ##### #  ## # # ### ### ##    ##           #
# # #  #  # ###  #### # ##### # #### ###############   # ##         ##    ###   ## ####### #####   ## #    ######### #   #    ####  ###########
# # ##   ##  ###  ##  # # ##     ##  ##     # # ## # ###  ##### ###### #####  #    ###   # # # ###    ## ###  # # #    ### ####  ##        # ##
# # #### ## ## ## ## ## #  #### ##  ### #####          ##  # ##    # # ### #### ##     # ### #  ## # ##      ##     #####   # ##    ## #####  #
#   # #   # ##        # # ## ## ## ##       ## ########### # #  ####   # #  ##  ##### ###### # #####    ######## #####    # #    ##  ###     ##
### # ### # ######## ## #  #     #  ## #######    ####  ## # # ## ####     ####    #### #  # # # #### ###    ##    ##  ###### ######  ### #####
#   # # # # # # # #   # ## ##### # ##     ## # ####  ## #      ##  ##  ### # ## ####    ## # #   # #    ## ###  ##### #### #       #### # # # #
# #       #   # # ### # ## # #      ## ####  # ## ##  # #### #### ####   ### #   # # ##### # # ### ## ####   ##    #         # ## ### # #     #
# ####### ## ## #  #  # ## # ######  #    ## # #   ##     ## ###  # ## ####  # ###     # # # #  ## #       ###  ##   # #### ##  ####  # # #####
####      ## #  ## ## # ## # # ## # ## #####     ##### #####   ## #  # #  ## # # # #####       ###   ####### ## ########  ######## ##   #     #
## ###### ## # ##     # #  # # #  #      ##  ###### ## #   ## ### ## #   ##  # #       #### #### # #####      #       ###  #        # ### #####
#  # # #   # #  ##### # # ##   ## # ####  ## ## #      # # #  # #  #   ##### # # ######## #  # #         ####   ####### ##   #### #           #
## # # ###   # ###         ### ## # # #####     ### ######   ## ##   ####  # #       # #    ##   ## # # #######            #   #### ## # # # ##
## #    #### # # ####### ####       #   # ## #####    # #  ####  # #### ##     # ##### # # ##### ######       # ######## # ## ##  #  ##### ####
#  ### ## ##   # # # #   #  #######   ### #    # ## ### # ### ## #  # # #  # # # # # # # # ## ## # #  #### # ##        # #  #### ######### ## #
## ### ##  ## ##   # ###   ###    ### ### # ####  # # # #  #  ##   ##     #### #       ### ## ## # # ########### ## # ## ######  # ### # #    #
#         ##   ### # # # ### #### ##  # # #    # ##       ## #####  ## #### ## ## # #####                    ###########   ## ##     #   ######
######### ####  ## # # # # #  ##  ### # # # #### ## ##### ##    ###  #    # ##### ####  ##### ## ######### #  # ## # # # #       # #   #      #
###   #    ### ##    # # # # ##  ## #        # # ## ## ####  #### # ## ####  ## # ## # ##  #   #         # ## # ##     ##### ## ## # # # ######
# ### ### ## #  ####         ### ## # # # ## # # ## ## # #  ##    #     ##  ### ####    ## # ###### ###### #### ### ## ## ######## # ###      #
#  ## ##  ## # ##  ## ### #### # #    ### #### #    ## # # ###### # ###    ## #  ##  #####       #### # #### #   ## ####    #    ####### ## # #
# ##  ###       ## ###### # ## # ## #  #### #    ## #       # ##    ########    ####   # ### #####       ###   # ##   ### ### ##### ## ########
# #  ##   ##### ## # #      ##   ## ## # #    ######## ###### #  ##     # ## #### ## ###  #     ## ####### # ###    #  #        # #     #  # ##
#   ##  # #      # # ##### #####  #  ### ## ### ## # #      # ## ########  #   ## ## # ## # ###### # #####     ### ###   # ####   ## ##   ##  #
###  ###########      # #   ## # ## ###          # # # ###### #  # ### ### # ####    # ##   # # #        # ####### # ###############  ## ### ##
#   ## ### #   # #### # ### ## # ## # ### ########         ## ##        ## #  ##  ####  # #       ######## # ### ### ## #  #   ###   ######   #
### ##  #  ### #### #   ##   #   ## # # # # #### ### #### ###    ########    ##  ##  # #### ####### # # #    # # ##  #  # ## ### ## ##  ##  ###
# #  ## ## ##   # # ###  # # # ###               ##   # ####  ##    ## ## ######  ##    ##    ### #       ##      ##   ## ## ##  ##  ##    ####
# # ##      ###   # ### #### #  ## ### ######### #  ###  ##  ########   # ### ## #### #    ##       #### ########### #        # ### #### #### #
# # ### ###   ###       # #    ### # ### # # # ####   ##    ## ####   ### # #  # # #  # # ##  ### ######## ### # # # ### ## #                 #
#     ###### ## ##### # # #### ##    ##         # # ###  ##### #  # ####      ## #   ############       #    # #       #  # ## # # ## # # #####
# ######         # ####   ## #  # ###### #### ### #  ## ##   #   ## #    # # ##  # ##### # ###  # ## # ## #### # ## #### ####  ############# ##
# ## # #### #### #    ###  # ## # # # ## # #####    ###  ###   #### # ########## #   ##    #   #########          #    # #  ######## # # #    #
# ## # # #####     #### ## # #        ## #   # # ##   ##   # ####        ## # #  # ###  ## # ### ##  ### ##### ####### ### ## #  # # # # # ####
#  # # # # # #####   #       # ## # ###    ### #### ###  # # ###  ######### # ##    ### #### #    # ## # #  ###### # #####    # ##         # ##
##   # # # # #     # #######   ###### # #####   ##    ## ### # ##     #  #    #### ## # # ## # ####        ##         ## # ####    # # # # #  #
#### #     # #######    # #  ### # #  #  #  # ###### ##   ## #  # ###   ## #### #  ##               ## ###    #######       ### ############ ##
# #  ##### # #   #   ## # ##  ## # # ## ## ##  #####  ## ##  # ## ### #       # ##  ### ###### ####  #   ## ### ####### #####      ## #   ##  #
# ## ##    # ### #####  # ###  # # #    ##  ##  ## # ###  ##        ###########  # ## #     ##  # ######  #           #     ## ### #    ###  ##
#     #### # ##  # ####    ### # #   ## ###  ##  #     ## #  ######  ##      ###   ## # ## ####       ### # ## ######### ####    ### #### ## ##
# ###  # # #  ##     #### ## # # # ###### # #### # #####  # ### ####  ## ##### ###       ###    #####  ## #  #    #####    ## ## ###    # #   #
# ### ## # # ###### ##     # # #   ## ##  #  # #    # ## ## # # #  ##     ## # # # ### #   ####     ## #### ## ##     ######  #### # ####   ###
# #           ## #   ### #       ###   # ## ## # # ##  # #        ##### #  # #       # # ### #### ####   ####  ## ######   ## # ##      # ### #
# ## # ## # #  # ## ####### # ####   ###  # #  # #### ## # ################# ## ## ### #        #### ###    ##  # ###  ## ##    ## ## ### #   #
# #  # #######    # ## #    #  # # ###   ##   ##  ##  #  # # ##### ##  # #       # ### ###########     ## #### ##     ### #### ### ###### # ###
# ## #  ## # ####   ## # #### ## # # # ###  ###  ### ## ## # #      # ## ## ######## ####### ##    ## ##     #  # # ####   ##      # ## # #   #
###  ## #     # ### ## ### #  ## #     #   ## ## # # #         ###### ## ## ##  # #           ## ######## ###########  ## ######## # ##     ###
#   #########           #  ## ## # ##### ####  #       #### #### # #         ## # # ###### ####   ## # #####   # # ## ##   # #  ## # ## #######
# #######     # ## #### ## #       # # #  # # ## #####    #          ## ## #### # #      #####  #    #    #  ###   ##    ### # ##    ##       #
#### ## ### ### ## ##        # # # # # # ## #      # # # ## # #### ###########  #   #######    ####### #### ## ### ## #### #    # ## ## #######
##   #      ############# ## # # #        # # ###### ########   ##    ### ## ##   #       ## ### ## ##   #      #  ## # ## # ######      # # ##
#  #   # # ##             #  ####### ###### # ##          ############# # ## ## ### ### ####      # ## ### #### # ##  # ## # # ###  # ##      #
##### ########## #### # # ##   ##     # #        ########## #### ###          #  ##  ##### # ### ##    #      ###  ## # ##      #  ####  # ####
###   #          ##   # # ### ##  # #   # #########  # ## # #  # # ### ### ##   ####  ##     # ###  #### ######## ##       ## #   ###### #   ##
#   # ########## #  #######    ## ### #   ######  # ## ## # # ## # # # ########  # ##  # ###     ##  ###    ###   ## #### ###### ## #  # # #  #
# # ####   # #   #####  ###########   # #        ##         # ## #        #   ##    ##    ########  ## # #### ## ##     #### # #      ## ### ##
### #    #     # ##    ## # ## #    # ### #### #    ## ####        # # ##   # ## ##  ## ### #####  ###     ##  # #  ######     ##### ###  ##  #
#   # #### # # # ### #           ## # ##    ###### ######## ## ########### ####   ## ##         ## # # ####### #   #### #  # #     #   ##  ## #
### # # #  ##### #   # # # # ## ##  #### #### #  #  # #   # #       # # ####  ###### ## ### # ####   # ## ## # # ###      ## # # ### ###  ##  #
#   ###   ###    ### #########   ## ##          ###     # # ## # ##       ## ##### # ##  ####### # ###     # #       # # ##### #   #   ########
### #   # #   ## ### ## # # ## # ## ### # # ## ## # ## #### ## ##### #######  #    #### ## # # #       ### # # ####### ####  # ### ## ## # #  #
#   ######### ## #   #         #  ### # # # ##    #  #    ###   ## ####### # ## ####       # # # #####   #           #### # ######  ####     ##
######   #    ## ## ## ##### ### ##     ### #  # ###### ###   #            #       #### ##           # # # ## # ## #             ##      ## ###
####   #   ########### ##     ##  ### #   #### #   ## #  #### ## # ## ####   ####### ##  # # ###############  ####### # ##########  ######### #
#  ####### ##     ## ###### # ## ##   # #   ## # #  # ##  #####  # ####### #          #### #        # # # ######   ####   #### # #####   # #  #
##  # # #   ##### ## ## #   #  #  ### # # ###  ####    ##     ## #       # ##########  ### # ## ###   #    # #   ### ####         ## ## ##   ##
### # #   ###             # # ### ##  # #  ###   ## # ##  # ###  # ## # ##        ###### ### ##  ## ### ##     ### # # ##### ## #  #       #  #
#       ###   ####### ### # # # # ## ## ## # # #  ###  ###########  # # ## # # #### ##     # ## ##       ## ##   # # #   ######## ## ## # #####
# # # # ### ###    #  #   # #   # ## ####    # # ##   ## # ## ###  ####### ###         ######## ### # #####  ###       ###     ##     # # # # #
### # # #   ###### # ## # # ## ## #### #  # ####  # #           ## #     #   # #### #####   # #   # #     ##   # # #####   # # ## # #####     #
##  ##### # #        #  ### #   ### #    ## # ##### ## # ### ####    ### #####    #  ###  #   ##### # ###  #######    ## ######## #    ## # ###
#  ##  ####### ## # ### ##  ###     ### ###       ###  #   #    ### ###      ### ###   ## ########### ####       #######   ###    ### ##  # # #
## ###         #  # ##  #  ##   # #####   # #####   ## ##### #####    ### ##   ####  #            ##     # # # #     # # #   ## #   ######### #
#  # ### ### ### ##  ##### #  # # ##    ###     ###  #    ##  ##   ##  ##  ## ### #### # # #### # ## # # ##### # ###     ## ##### #  # ### #  #
# ## ##  #   #    #######  ## # #  ## #  ## ## ##### # # ##  ##  # ## #########     ## ###  #####  # # #   ##  #   # ## ##### ######         ##
###     ## # # # ##       ##  #### ## # ##   #     ### #  ##  ## # ##    ## ##  # ###    ##     # ###### #  ## # # # ##  # ##   ##   ##### ####
#### # ####### #  ## # ## ### ## # #  # ### ######  ## ####  ### # ### #       ##   ########## ##      ####  # # # #####    # ###  #     #  # #
#    # ##      ##  #####   ####    ####  ## # ## #####    ## # # #  ## ## ## ###  #         ###### ###### ## # # #   ##  # ##   ## ## # ###   #
############## ## ####   #  ### ##    ## ##       ## ## # #    # # #####   ######### ######     ##    #    ####### #  ## #### ####### #  ### ##
## #  ## #      #### ## ## ##   ## ## ## #  # ###     ###### # # #    ## #   # # ##   ## ## ## ### ##   ##### #  # # #######    # ##  #### ####
#  ##      ## #### # #  ##  # # #  ## ## ## #  ## ###### # ####### # ##### #      ###     #  ### #  ## ####     ####         ##   ###         #
##    ### ##  ##       ##  ####### ## ##  # # #######          ### #  ##   ## # #  ## ### ## ### ####       # #   ## # ## ######### ## ## #####
#  # ##   ## ##  ## ##  ##  ###    ## ## ## #     # # ##### # ## # # ##### ## ### ### ######        ## # #############  #         # ##  ##### #
## #  ###  ##### ## #  ### ##   # ##  ##  # # ###   #    ####    # #   ##   #   #   #    # ##########  #  ## # # ##  ## ## ## #####  ##       #
#  # #######      ### ##   #  ###  ## ## ## #   # #   ##    # # ## # #  ### ## ### ## ##    ####### ## ##           ##   ####    ## ### # # ###
# ## #   #   ### ##   ## # ##   ## ##  ###  ## ## ## #### ########## #####   # ##  #  ## ####        # ## # # # # #### #  # ## #    # ### #   #
#  # # #   ###   ####  # # #  # ## ## ##   ##   # ##    ### ## # ##      ## ######### ##    # ######## #  # ### #    # ##    # ## #    ##### ##
## # # ## ##   # #    ## # # ##  # #  #  #  # # #  ## #           # # # ##        ##   ## #          # ## #   # # # ## #  # ## ## # ##    ##  #
############################################################################################################################################# #
