# ##############################################################################################################################
#   ##     ##        ## ##  #  # # ##     ##    # ##    # # # # # # # # ## # # ## ##   ## # #  #        #        # #  #  ###   #
## ###### ###### # #     ## ## #    #####  #### # #####                  # #    #  ### ## # ## ######## ##### #### ## ##  #  # #
#     ### # ###  ###### ##     ####  ## # ## #  #  ##   # # ###### #####   ####   ## #    #  # #  ##          ###  ## #  ## ####
## ## #       ##### ##  #### #  # # ##     # ## # ##  # # # ##############      ###  ####   ##   ### ######## # # ###   ##  # ##
####  #### #### ##   ##  # # ##      #####   #    ##### #####          # # ####  #  ###   ###  ### ### ###      #   ## ####    #
# ### #     # # #  # ### # ##### # #  ##   # ####  ################### # ####   ## ## ## ##   ###  ##  # ###### # ####  ##  ####
#       ###       ##   # # ## #######    ### ##   ##   ## # ##   # #      # ###     # #   ## ## ##  ## # #  ##      #  ####    #
### # ####  ### ###  #   # ## #       ####   ####  ### #    #### # ######   ####### # ## ##      ## #    ## #  ###### ## ## ####
# ###### ## ############   #  #### #########    ##  #  ### ## #     # ##### # ##      #  ## # # ### ## #    ##   #    ##       #
#   ###   ###         #### # ##  ####    ######  ## ## ##       ###           ####### ##  ### ####  ##### #    #   ####### ## ##
## ## ## ############   ## # ### ## ### ##   ## ### ##    #######   # # ## ##   #   #    ###   ##  ## ##  #### ####### ##  #####
#        ## # #       #      # # #         #    ##   #######      ### # ####### ### #### # ###  ## ##  ####     # ##    ## # ###
######## ## # # ## ###### ## # # ##### # # ####  ## ### ## ############## #            # # # # ##   ##   ######    # # ##     ##
###         # ###### # ####      ##  # ### ## # ##    # ##  ##      ## #    ## # #####   # # # #### #### # #    ###### ## # #  #
# ### ## # ##  ## #     ##  # ##  # ########     ### ## #  ######## ## ## #  ##### ##### # # #   #  # ## # ####  # ##   # ### ##
# # ###### ## ### #### ##  ###### #  ##   #  # #     ## ## ##        # ##### ## #            ### ## # ## # ## # ## ## #####    #
# #  # ##      #  #     #####  #    #####   ###### #    ## #########     ###### ### # # ####   # #    ## #  # # #   #  # #### ##
# ## # ####### ## ##### # # ##   ##  ##   # #      # ## #   # # ###### #  #     #   ###    ###   ### ##  ## # #   # # ## # ##  #
#      # #     #  ###       #  ##### ##################   # #   #  # #### ##### ### #   ###### #   #  ##      ## #### #  # ### #
###### # # # # ## # # ### # #####  #  ## # ##       # ## ###### ## # ##    ###  #   ### ##   ##### # ##  ####    # ## # ## # # #
#####  # # ### ##   ###   #   # ## # ##       ## ##      # ## # ##   #### ## ##   # # ###### #     # ###### ### ## ##   ## # # #
#   ## # ###    # #  ## ### #   #    ### ### ###########    #   ## ###        ## #### ## # # #####    # #           ###  #   # #
# # #  #  ##### #### #####  ### #### # ####### ### ### #### ###     ##### ###  # #         #    ### ### ####### ####### ## ### #
### ##   ## ##  ## # # # ###### ## # #  #  ##               # ## ##  ## ##### ############ ### ## #  ## # #     #  ## # #   ## #
##   ###     ##      # # # ##   #  # ##   ####### # #######      ###    ### #   #  ### #   ### #  ##  # # ##### # ##  # # ###  #
#  ### ### # ####### # #    ### ##   #  ###  ## #####       ## # #   ## # # ### # ## # ### # # ##  # ##            # ## #   ## #
##   #     #         # #### # # #  # ##   ##     # #  # # ###  # # # #                 ##      ###    ############ # ## ### ## #
#### ######## ## # #   # #  #   #### ### ##### #     ######   ########### # # ##### # ##### ##  ### #  # #      ##   ##  ## ## #
#      # #    #  # ### # ## ###   #   #  # ##  ########     #  ###        #####     #   #######     ##     # ##  ### ### ## ## #
#### ### #### ## #####       ####   # ##   ##### ## # ##### #### ### ########   ## ####    # ########  ## ######      #   # #  #
#     ## # #######     ##### # ###### ####  # #  #    # ##  #     ####      ## ##### ##### # # ############ #    ####   ### # ##
#####  #   # #   #### ###       #        ## # ##   ##      #### ### ### ### ####  #          # #    # # ##  ####### ### ##  #  #
## ###   #     #### ### #### ## ######## ## # #  #  ######## ##  ##   ###     ### ##########   ## #     #  ## #          ##   ##
#    ### # ## ## #  ##   ######        # ## #   ######## ##   # ### ####  ## ##     ##### #### ######## # ##  ######## #    ####
# ##     #### ## ##  ###   ##   #### # #    # ### #         #   # # ##   ##     # #        ##   ## # #       ### # # # ####    #
#### # # ##       ## #####  ##########   ## ###   ### # # ##### #    ################### #  ## ##    #### ##  #  # # ### ## ####
## #####  ## ####      # # ######      ####   ### ##  #####     # # ##     #   # #       ##     #### ## ##### ## # #  #   #  # #
#   # ### ####    # ##      #   ## # # ## ## ##    #####  ##### # ######## ###     ## ###### ##       # ## ##    # ## # # ##   #
###    #### ### # ######### # ###  # ###     #### ## ##  ## ##    ## # #     ## ##  ###### ###### # #         ##   ## ###  ## ##
######  ###     ##### #         ######### ##   ## ##  ## #     ## #      # #    ## ###        ##  # # # # ###### #  # ##  ##   #
#  # ## # ## ####       # # # # #  ### #######    #  ### ##### #    ## ###### # ## ##  ## # # ## #### #####  # ####   ###    ###
##      # ####  #### ## ####### # ## # # #     ##   ##   # #   # ##  #### # # ######## ## # #  ### ####  ###    #####     ##   #
####### # # #  ## ########        ## # #   ## #####  ###     ##########       #        #  # ##  #     ##   ## #  ## #### #######
#       #   ##    # # ## # # # ##      # #  ### #### # ## ## ## ## #  ############ ## ### ##### ## ##  ###  #### #  #       ## #
#######   #    ##   # #  ##### ####### #######       # #   # #     ## # ## #### ##  ### #####   ##  #### ## ## # ## ## # # ### #
#       #### #  ###   ##       #        # ## ### # #     # ##### #  #      #     ## ##  ### ### ###  ##           # #### ####  #
# ## # ##    #####  #    ##### # # #### #        # # ## ##### ##### ###### ### #  #####           ##  ########### # # #   # ## #
# #  ###########   ### # ###   #####    ### #### # ###### # # # #           #####  ## ######### #  ##  # ### # #  # # ## ## ## #
# ####     #   ## ##   # #   #### #  ## #   #    ###            ## # ###### # # ## ##           ##  ## # #     ## # #  #       #
# #    # #   #     ### ##### #      ###   # # ##  ###### ##### ######## #     #    ########## # ###      #####  # # ## # ### ###
#### # # ## #### ### # ## ## # # ## # ## ########## ##   #      # # ##    # # ####   ## ## ###### ### ## ## ###        #   #   #
## #######  ##   #     #     ######## #  # # ## ##   ## ### # #        # ## #      #       # # ##  ####       ######## # #### ##
#     # ########## # # # # ####    #    ##       ### #### ###### ## # ####### ### ### ## #      ##   ########      # #     #####
##### #  # ## #### ### # # #    ##   ## ### ### ## #   #  ##   # ######### ################ # #  ### #    ##  ## #     # #  ####
###   ##            ######### ###  # #  #   #   ## ## ## ##  # ### # # # #  ##  ## #   ## ######     #### #  ##  ### ###### # ##
#   #  ######### # ## # ##  ####  ######### ###       ##  ####  ## #   # # #### #  ### #  ## # ##### ## # ####  ##    # # ###  #
###### ##        # #     ## ## #### # ## ######### ##    ##  ## ##   #      ##    ##   ##  # # #            #########       # ##
#       ######## # # ### ## #    #         ##  ######### ## ##  ########### ## ## #### ### # # ########## #  # # #    ### #    #
# ## ##  ##   ## # ###      ## #   # ## ##  ##    ## ##  #  ###  # ## ## #   # #   ##      # #   # ##     ##       ##   ##### ##
####### ##### ## # #   ####    # # # #   ##  ####     ## ## # ##         ## ##### ##  #### # ###    ### #  ## ######  #    #####
## ##   ## #   ###### ### ##################      ###            # ### #     ## # ## ####      ## #   ##########     ### #    ##
#  #  #  # ### ###    #   # ##   ###   ### ###### ##  ## #### ## ########### ##   ##### #### #  ### ########     ### ##  ## #  #
## # ### # #     ### ####    ## ## ### # # #### ##### ## #     ####   # #     ### # ##       ##  ## # # #  #### ##   ###  # ## #
#  ####    ### # # ###  ### ##      #  #         ## # ## ## # ##    #     # #        # #########      # ## ######  #  ## ####  #
##  # ### ###  ### ##  ##   ####### ## #### ## #  #   ########## #### # # # ## ## ## ####      ### ##             ###  #    # ##
###   # #   ##  ##  ##  ### # # ##      ######### ##### #  ### ###    ### #########   # ###### ##  ####### # # ## ##  ## ## ####
# # # # # # ### ### #  ####      ###### # ##      # ### ##  #   ############  ## ####             ## ####  # # #   ## ####     #
#   #   ### # #  ##   ###   ## #        #  # # ## #     ### ### # # ##  ## ##  #   ## # # ## # # ##       #### ## ###   ########
### # #  #    # ##### # #####  ### # ##   ######    ### # #         ### #   ## # #    #####  ####### ### ## #   # #   #     #  #
########   ##    ##      # ### ########## # # #  # #### # #### ## #     ### #    # ## #     ### #    #      ### # # # ## ##   ##
# ## # ## ### ##  ### ##    ## #  # # # # # #   ####      ######### # # ### ### ## ## # #####     # ## # # ##   # # # #  ## #  #
#         #    ## ### ## ## #####             #  ### ## #    ## ##  ###     #   ##  ###### ##### ####### #  ### ### ####  # ## #
# # # # ### # ##      ####  #  ## ## ## # ######## ######### #   ## ### # #   ###  ##  # #         ##    ## ##    # #    ## ## #
##### ##### ##### ## ## ### # ##   ##########  #    ## # ### # ###### ###### #########     # ## # ##### ##  ### # # ### ##  ## #
#     ##    #     ## ##     # ######   # ## ## ## #    #        ## #      #####  ###   # ### #  ###      ## #   ####### ## ##  #
# # ###  # ## #####   ## ##          #          #### #   ## ###  # ##### ## # ## # ############   ## ## ##  # #    ##   ## ### #
######## # ######   # #   ## # # ### ## #######  # ### #  ######   # # # ##      # ##   #   ##  ######   ####### #  ### ## # # #
#     ###### #    # #### ######### ###### ###### #     # ###  #### # # # ##### #    ### ###  # ##      #####     ###### ##   # #
## ##  #####   # ##### #### #      ##  #           # # ###   ## #           ##### ####   ###   #### ## ##    # #  ### ##### ## #
###### # # #####  ##    # # ## ### ### #### ### ## ######  #      # # # ###  ###   # ###     #   ##  # #  # #####       ##  ## #
# #        # ##  ##  ##     ## #        #   #   #  #  # ###### ## # # # #   ## ### # ### ### # #### ## ## ###     ## # ##  ##  #
# ########   #  ######  ### ###### ####   # # # #####    ################## #             ## #  ##   ######   ## ##### ###  # ##
# ###      # ## ##  #  ###   ##  ###    # # # ##### ### ## # #   # # # # #    # ## ## # # ##### ########    # ##  ##     # ##  #
# # ###### #  ##### #### ### ## ##   # #########     #         #         ## # # ## #  ###   # #     ## ## ###  ##  #### ## ### #
#   # ####### ###   #            ### ### # #   #####   # # ### # # # ###    # # ## ## ##  ### # #####  #   ###  ## ##   ##   # #
### # #   # #   ###   ## ####### #   ### # ### #     # # ###   #######   ## #####  #  ### #     #   ##   # #   ##  ## #  ## ####
# #     #     #  ####  ###       ##### # # # # ##### # ###   # ############   ##  ### #   # ###   # #  # # # # ###  # ##  # # ##
#   # # ##### ##      ########## # ##    #     # ##  # #### #### # #        ###  ## ##########  # # ## # # # # #   ## #  ##    #
# # ############# ## ##       #       ## #####      ## #     ##      # ## #  ### #             ## #  # # # ### ## ### ##  #### #
###### #          ## ##### ##   # # # #  # #### # ###  ## ###### # # # #####   #### # ### ## # #### #### ########   # #  ####  #
## ##    # ###### ## # ###### ### # # ##        #  ### ##  ## ## # #####   # ###  ### #   ## #  ##    ##  ## ##   # ####    # ##
#     ## #  ##### #  #    # # #   ####### # ### ## # ##### #     #   ##### #   ##  #### # #  ####  # ##  ##   ### #### # # ##  #
# ## ##  # ##   #########     # # ###########   #     ##   ####### ### #     #####   ## # ##    ## # ###  ###          # #  # ##
####### ####  #  # ## ###### ###### # ##   ### ## # #### # #       ##  #####   ##  #    ##### #  # #  ## ##   #### ######## #  #
#         ### ##             # # ##   ####     #### ## ########### ###       #### #### ####   # #### ##   # #####      ###### ##
## # # #### #### ### ## ## # #      #      # #  ##  #   ##  #      #   ### #  # ###    ##   # #  ##   # ######    # ##   ##    #
## # # #     #   ##   #### # # # ## ###### # # ########  ##   ## # # # ##  ##     ## # #### ### #### ##### #   ## # ## #  ## # #
#  #########   #  ## ##    #######  ##     ##### ###  ##  ## ####### # ## ### ###### # #     ## # #   ##     # #  #  # # ##  # #
# ####   # ## ########### ##    #####  # #### ## # # ##  ###### # ## ######   ### #  # ## # ##    ## ##  ##### ## # ## #  # ## #
###    #         ## #     ## ##    ## ####     # # #  ## ##           # ##### #     ## ## # ## # ##   ## #      ### #### ## #  #
##### ## # # ## ##  ## # #########  ### #  ###   # # ##   #### # # # ## # #   # ###  ###  # #  # ## ###  ### ##  ##    #  # ## #
#     #  # ###   ##  ###### #   ## ###  ####   #   # #### ###  # ### ##   ### ######  ## #########    ## ##   ## #  ##### # #  #
## ## ## # #   # #  ####  # ###      ## ##   #####   # #  # ####  ##  ###       # ## ##   ## ## ## ####  ### ### ##    #### ## #
#######  # ### ####  # ## # ##  # ##     #####     #   ##        ############ ###     # # #           ## #   #    ## ###  #  # #
# #     ## #      ##   #     ## ###### #       ##### #    # # #### ####         #### ## ###### # # ######### ## ####     ## ## #
#   # #  #### # ######   ###    #   #  ##### # #     ### ######         # ## ## #     ###      # #    # #    #  ##   ## ##  ####
# # # ## #    #### #   # #### ##### # ##     # # ######   ##    ## # ## ####  # # # ##### # ## # ## ### # # ## ##  #  #  ##    #
# # ####### # ## #   # ###    #        ### # # ###      # #### #####  ###    ## ###     ###### ####     ######  #### #####  # ##
# # #       ###    # # #   # ######## ###### ###### ### # #    ## #  ###  ## ## #   # #  # # #  ##  # # ##     ###      ### #  #
# # ##### # #### # # ##### ### #      ##     ###    ##  # ####    ## ##  ##  ## ### # # ##     #### # #  #####   ## # #  #### ##
# # ######### ## ###### #  ##  ##### ##### # #   # #### ###    # ##  ### ## ##  ##  # #  ### # ##   #### #     ###### ##  ######
# ###         ## #        ####  # #  ## #  ### # ###    #   # ## #####    # ### ### # ## #   # #  #    ### # #      # ###      #
# ##  # #####    ## ## # ##  ## # # ##  # ###  #   ####### ## ## #     # ## #   # # ###  ## ## # ### #   ##### ########   ## ###
#  #### # ### # #####  #####         ##   #   ### ##       #  ##### # ## ## # # #    ## ##  ## # ##  # # ## #       ##  #  #   #
## #    #     #### ####### #### ## # ### ## # #    ##########   # # # #  #  # # ## #  ##### #### ### # # #    # # #  ## # ## ###
#  # ## ## # ##                 #  ### #  ####### ##          ###   # ## ## # # #  ##   ##    ## #   # ### ## # # # ##  # ##   #
## ###  #  # ## ## # ## # # # # ## ##    ### ## ##### ### ###   ## ## #  #  # # ####  ###  # ##  # # ###   ## # # # ## ##  ## ##
########## # ## #  # #  # ##### ## ##### ##      ## # ### ##  #### #### ##### ### ###  ## ## #  ## #   ### #  ### # #  ## ##   #
#        ### #  ## # ## # #  #  #  #     #######      #    ##    #    ### ##  ##      #####  # ##  ###  ## ##   ##### #####  # #
# # ####     # ##  # ####### # ### ### # #       ## # ### #### #### ###      ##  ## #  ##   ## ### ##  ### ## #### ## #   # ## #
# # #    # # #  ## # #         #   ##  # ## # # ##  # #   ##     ##   ## ## #### #  # #### ##  #    ## ##  ##  ##       # # ## #
############################################################################################################################## #
