#.##############################################################################################################################
#...##.....##........##.##..#..#.#.##.....##....#.##....#.#.#.#.#.#.#.#.##.#.#.##.##...##.#.#..#........#........#.#..#..###...#
##.######.######.#.#.....##.##.#....#####..####.#.#####..................#.#....#..###.##.#.##.########.#####.####.##.##..#..#.#
#.....###.#.###..######.##.....####..##.#.##.#..#..##...#.#.######.#####...####...##.#....#..#.#..##..........###..##.#..##.####
## ##.#.......#####.##..####.#..#.#.##.....#.##.#.##..#.#.#.##############......###..####...##...###.########.#.#.###...##..#.##
####..####.####.##...##..#.#.##......#####...#....#####.#####..........#.#.####..#..###...###..###.###.###......#...##.####....#
#.###.#.....#.#.#..#.###.#.#####.#.#..##...#.####..###################.#.####...##.##.##.##...###..##..#.######.#.####..##..####
#.......###.......##...#.#.##.#######....###.##...##...##.#.##...#.#......#.###.....#.#...##.##.##..##.#.#..##......#..####....#
###.# ####  ### ###  #...#.##.#.......####...####..###.#....####.#.######...#######.#.##.##......##.#....##.#..######.##.##.####
# ###### ## ############...#..####.#########....##..#..###.##.#.....#.#####.#.##......#..##.#.#.###.##.#....##...#....##.......#
#   ###   ###.........####.#.##..####....######..##.##.##.......###...........#######.##..###.####..#####.#....#...#######.##.##
## ## ## ############...##.#.###.##.###.##...##.###.##....#######...#.#.##.##...#...#....###...##..##.##..####.#######.##..#####
#        ## # #.......#......#.#.#.........#....##...#######......###.#.#######.###.####.#.###..##.##..####.....#.##....##.#.###
######## ## # #.##.######.##.#.#.#####.#.#.####..##.###.##.##############.#............#.#.#.#.##...##...######....#.#.##.....##
###         # ######.#.####......##..#.###.##.#.##....#.##..##......##.#....##.#.#####...#.#.#.####.####.#.#....######.##.#.#..#
# ### ## # ##  ## #.....##..# ##..#.########.....###.##.#..########.##.##.#..#####.#####.#.#.#...#..#.##.#.####..#.##...#.###.##
# # ###### ## ### ####.##..######.#..##...#..#.#.....##.##.##........#.#####.##.#............###.##.#.##.#.##.#.##.##.#####....#
# #  # ##      #  #.....#####..#....#####...######.#....##.#########.....######.###.#.#.####...#.#....##.#..#.#.#...#..#.####.##
# ## # ####### ## #####.#.#.##...##..##...#.#......#.##.#...#.#.######.#..#.....#...###....###...###.##..##.#.#...#.#.##.#.##..#
#      # #     #  ###.......#..#####.##################...#.#...#..#.####.#####.###.#...######.#...#..##......##.####.#..#.###.#
###### # # # # ## # #.###.#.#####..#..##.#.##.......#.##.######.##.#.##....###..#...###.##...#####.#.##..####....#.##.#.##.#.#.#
#####  # # ### ##   ###...#...#.##.#.##.......##.##......#.##.#.##...####.##.##...#.#.######.#.....#.######.###.##.##...##.#.#.#
#...## # ###    # #  ##.###.#...#....###.###.###########....#...##.###........##.####.##.#.#.#####....#.#...........###..#...#.#
#.#.#  #  ##### #### #####..###.####.#.#######.###.###.####.###.....#####.###..#.#.........#....###.###.#######.#######.##.###.#
###.##   ## ##  ## # # # ######.##.#.#..#..##...............#.##.##..##.#####.############.###.##.#..##.#.#.....#..##.#.#...##.#
##...###     ##      # # # ##...#..#.##...#######.#.#######......###....###.#...#..###.#...###.#..##..#.#.#####.#.##..#.#.###..#
#..### ### # ####### # #    ###.##...#..###..##.#####.......##.#.#...##.#.#.###.#.##.#.###.#.#.##..#.##............#.##.#...##.#
##...#     #         # #### #.#.#..#.##...##.....#.#..#.#.###..#.#.#.#.................##......###....############.#.##.###.##.#
####.######## ## # #   # #  #...####.###.#####.#.....######...###########.#.#.#####.#.#####.##..###.#..#.#......##...##..##.##.#
#......#.#    #  # ### # ## ###...#...#..#.##..########.....#..###........#####.....#...#######.....##.....#.##..###.###.##.##.#
####.###.#### ## #####       ####...#.##...#####.##.#.#####.####.###.########...##.####....#.########..##.######......#...#.#..#
#.....##.#.#######     ##### # ######.####..#.#..#....#.##..#.....####......##.#####.#####.#.#.############.#....####...###.#.##
#####..#...#.#...#### ###       #........##.#.##...##......####.###.###.###.####..#..........#.#....#.#.##..#######.###.##..#..#
##.###...#.....####.###.#### ## ########.##.#.#..#..########.##..##...###.....###.##########...##.#.....#..##.#..........##...##
#....###.#.##.##.#..##...######*,,,,,,,#.##.#...########.##...#.###.####..##.##.....#####.####.########.#.##..########.#....####
#.##.....####.##.##..###...##   #### #,#,,,,#.###.#.........#...#.#.##...##.....#.#.....,,,##...##.#.#.......###.#.#.#.####....#
####.#.#.##.......##.#####..##########,,,##,###...###.#.#.#####.#....###################,#,,##.##....####.##..#..#.#.###.##.####
##.#####..##.####......#.#.######      ####,,.###.##..#####.....#.#.##.....#...#.#,,,,,,,##,,,,,####.##.#####.##.#.#..#...#..#.#
#...#.###.####....#.##......#...## # # ##.##,##....#####..#####.#.########.###.,,,,##.######.##,,,,,,,#.##.##,,,,#.##.#.#.##...#
###....####.###.#.#########.#.###  # ###....,####.##.##..##.##,,,,##.#.#,,,,,##,##..######.######.#.#,,,,,,,,,##,,,##.###..##.##
######..###.....#####.#.........#########.##,,,##.##..##.#....,##,#,,,,,,#.#,,,,##.###........##..#.#.#.#.######.#,,#.##..##...#
#..#.##.#.##.####.......#.#.#.#.#..###.#######,,,,#..###.#####,#.,,,##.######.#.##.##..##.#.#.##.####.#####..#.####,,,###....###
##......#.####..####.##.#######.#.##.#.#.#.....##,,,##...#.#,,,#.##..####.#.#.########.##.#.#..###.####..###....#####,,,,.##...#
#######.#.#.#..##.########........##.#.#...##.#####,,###.,,,,##########.......#........#..#.##..#.....##...##.#..##.####,#######
#.......#...##....#.#.##.#.#.#.##......#.#..###.####,#.##,##.##.##.#..############.##.###.#####.##.##..###..####.#..#...,...##.#
#######...#....##...#.#..#####.#######.#######......,#.#,,.#.#.....##.#.##.####.##..###.#####...##..####.##.##.#.##.##.#,#.###.#
#.......####.#..###...##.......#........#.##.###.#.#,,,,,#.#####.#..#......#.....##.##..###.###.###..##...........#.####,####..#
#.##.#.##....#####..#....#####.#.#.####.#........#.#.##.#####.#####.######.###.#..#####...........##..###########.#.#.#.,.#.##.#
#.#..###########...###.#.###...#####....###.####.#.######.#.#.#.#...........#####..##.#########.#..##..#.###.#.#..#.#.##,##.##.#
#.####.....#...##.##...#.#...####.#..##.#...#....###............##.#.######.#.#.##.##...........##..##.#.#.....##.#.#..#,......#
#.#....#.#...#.....###.#####.#......###...#.#.##..######.#####.########.#.....#....##########.#.###......#####..#.#.##.#,###.###
####.#.#.##.####.###.#.##.##.#.#.##.#.##.##########.##...#......#.#.##....#.#.####...##.##.######.###.##.##.###........#,..#...#
##.#######..##...#.....#.....########.#..#.#.##.##...##.###.#.#........#.##.#......#.......#.#.##..####.......########.#,####.##
#.....#.##########.#.#.#.#.####....#....##.......###.####.######.##.#.#######.###.###.##.#......##...########......#.#,,,..#####
#####.#..#.##.####.###.#.#.#....##...##.###.###.##.#...#..##...#.#########.################.#.#..###.#....##..##.#..,,,#.#..####
###...##............#########.###..#.#..#...#...##.##.##.##..#.###.#.#.#.#..##..##.#...##.######.....####.#..##..###,######.#.##
#...#..#########.#.##.#.##..####..#########.###.......##..####..##.#...#.#.####.#..###.#..##.#.#####.##.#.####..##..,,#.#.###..#
######.##........#.#.....##.##.####.#.##.#########.##....##..##.##...#......##....##...##..#.#.#............#########,......#.##
#.......########.#.#.###.##.#....#.........##..#########.##.##..###########.##.##.####.###.#.#.##########.#..#.#.#...,###.#....#
#.##.##..##...##.#.###......##.#...#.##.##..##....##.##..#..###..#.##.##.#...#.#...##......#.#...#.##.....##.......##,..#####.##
#######.#####.##.#.#...####....#.#.#.#...##..####.....##.##.#.##.........##.#####.##..####.#.###....###.#..##.######,,#....#####
##.##...##.#...######.###.##################......###............#.###.#.....##.#.##.####......##.#...##########....,###.#....##
#..#..#..#.###.###....#...#.##...###...###.######.##..##.####.##.###########.##...#####.####.#..###.########.....###,##..##.#..#
##.#.###.#.#.....###.####....##.##.###.#.#.####.#####.##.#.....####...#.#.....###.#.##.......##..##.#.#.#..####.##,,,###..#.##.#
#..####....###.#.#.###..###.##......#..#.........##.#.##.##.#.##....#.....#.#........#.#########......#.##.######,,#..##.####..#
##..#.###.###..###.##..##...#######.##.####.##.#..#...##########.####.#.#.#.##.##.##.####......###.##.........,,,,###..#....#.##
###...#.#...##..##..##..###.#.#.##......#########.#####.#..###.###....###.#########...#.######.##..#######.#.#,##.##..##.##.####
#.#.#.#.#.#.###.###.#..####......######.#.##......#.###.##..#...############..##.####.............##.####..#.#,#...##.####.....#
#...#...###.#.#..##...###...##.#........#..#.#.##.#.....###.###.#.#.##..##.##..#...##.#.#.##.#.#.##.......####,##.###...########
###.#.#..#....#.#####.#.#####..###.#.##...######....###.#.#.........###.#...##.#.#....#####..#######.###.##.#.,,#.#...#.....#..#
########...##....##......#.###.##########.#.#.#..#.####.#.####.##.#.....###.#....#.##.#.....###.#....#......###,#.#.#.##.##...##
#.##.#.##.###.##..###.##....##.#..#.#.#.#.#.#...####......#########.#.#.###.###.##.##.#.#####.....#.##.#.#.##..,#.#.#.#..##.#..#
#.........#....##.###.##.##.#####.............#..###.##.#....##.##..###.....#...##..######.#####.#######.#..###,###.####..#.##.#
#.#.#.#.###.#.##......####..#..##.##.##.#.########.#########.#...##.###.#.#...###..##..#.#.........##....##.##.,..#.#....##.##.#
#####.#####.#####.##.##.###.#.##...##########..#....##.#.###.#.######.######.#########.....#.##.#.#####.##..###,#.#.###.##..##.#
#.....##....#.....##.##.....#.######...#.##.##.##.#....#........##.#......#####..###...#.###.#..###......##.#..,#######.##.##..#
#.#.###..#.##.#####...##.##..........#..........####.#...##.###..#.#####.##.#.##.#.############...##.##.##..#.#,,..##...##.###.#
########.#.######...#.#...##.#.#.###.##.#######..#.###.#..######...#.#.#.##......#.##...#...##..######...#######,#..###.##.#.#.#
#.....######.#....#.####.#########.######.######.#.....#.###..####.#.#.#.#####.#....###.###..#.##......#####....,######.##...#.#
##.##..#####...#.#####.####.#......##..#...........#.#.###...##.#...........#####.####...###...####.##.##....#.#,,###.#####.##.#
######.#.#.#####..##....#.#.##.###.###.####.###.##.######..#......#.#.#.###..###...#.###.....#...##..#.#..#.#####,......##..##.#
#.#........#.##..##..##.....##.#........#...#...#..#..#.######.##.#.#.#.#...##.###.#.###.###.#.####.##.##.###...,,##.#.##..##..#
#.########...#..######..###.######.####...#.#.#.#####....##################.#.............##.#..##...######...##,#####.###..#.##
#.###......#.##.##..#..###...##..###....#.#.#.#####.###.##.#.#...#.#.#.#.#....#.##.##.#.#.#####.########....#.##,,##.....#.##..#
#.#.######.#..#####.####.###.##.##...#.#########.....#.........#.........##.#.#.##.#..###...#.#.....##.##.###..##,,####.##.###.#
#...#.#######.###...#............###.###.#.#...#####...#.#.###.#.#.#.###....#.#.##.##.##..###.#.#####..#...###..##,##...##...#.#
###.#.#...#.#...###...##.#######.#...###.#.###.#.....#.#.###...#######...##.#####..#..###.#.....#...##...#.#...##.,##.#..##.####
#.#.....#.....#..####..###.......#####.#.#.#.#.#####.#.###...#.############...##..###.#...#.###...#.#..#.#.#.#.###,.#.##..#.#.##
#...#.#.#####.##......##########.#.##....#.....#.##..#.####.####.#.#........###..##.##########..#.#.##.#.#.#.#.#.,,##.#..##....#
#.#.#############.##.##.......#.......##.#####......##.#.....##......#.##.#..###.#.............##.#..#.#.#.###.##,###.##..####.#
######.#..........##.#####.##...#.#.#.#..#.####.#.###..##.######.#.#.#.#####...####.#.###.##.#.####.####.########,..#.#..####..#
##.##....#.######.##.#.######.###.#.#.##........#..###.##..##.##.#.#####...#.###..###.#...##.#..##....##..##.##..,#.####....#.##
#.....##.#..#####.#..#....#.#.#...#######.#.###.##.#.#####.#.....#...#####.#...##..####.#.#..####..#.##..##...###,####.#.#.##..#
#.##.##..#.##...#########.....#.#.###########...#.....##...#######.###.#.....#####...##.#.##....##.#.###..###....,,....#.#..#.##
#######.####..#..#.##.######.######.#.##...###.##.#.####.#.#.......##..#####...##..#....#####.#..#.#..##.##...####,########.#..#
#.........###.##.............#.#.##...####.....####.##.###########.###.......####.####.####...#.####.##...#.#####.,,...######.##
##.#.#.####.####.###.##.##.#.#......#......#.#..##..#...##..#......#...###.#..#.###....##...#.#..##...#.######....#,##...##....#
##.#.#.#.....#...##...####.#.#.#.##.######.#.#.########..##...##.#.#.#.##..##.....##.#.####.###.####.#####.#...##.#,##.#..##.#.#
#..#########...#..##.##....#######..##.....#####.###..##..##.#######.#.##.###.######.#.#.....##.#.#...##.....#.#..#,.#.#.##..#.#
#.####...#.##.###########.##....#####..#.####.##.#.#.##..######.#.##.######...###.#..#.##.#.##....##.##..#####.##.#,##.#..#.##.#
###....#.........##.#.....##.##....##.####.....#.#.#..##.##...........#.#####.#.....##.##.#.##.#.##...##.#......###,####.##.#..#
#####.##.#.#.##.##..##.#.#########..###.#..###...#.#.##...####.#.#.#.##.#.#...#.###..###..#.#..#.##.###..###.##..##,...#..#.##.#
#.....#..#.###...##..######.#...##.###..####...#...#.####.###..#.###.##...###.######..##.#########....##.##...##.#.,#####.#.#..#
##.##.##.#.#...#.#..####..#.###......##.##...#####...#.#..#.####..##..###.......#.##.##...##.##.##.####..###.###.##,,..####.##.#
#######..#.###.####..#.##.#.##..#.##.....#####.....#...##........############.###.....#.#.#...........##.#...#....##,###..#..#.#
#.#.....##.#......##...#.....##.######.#.......#####.#....#.#.####.####.........####.##.######.#.#.#########.##.####,....##.##.#
#...#.#..####.#.######...###....#...#..#####.#.#.....###.######.........#.##.##.#.....###......#.#....#.#....#..##..,##.##..####
#.#.#.##.#....####.#...#.####.#####.#.##.....#.#.######...##....##.#.##.####..#.#.#.#####.#.##.#.##.###.#.#.##.##..#,.#..##....#
#.#.#######.#.##.#...#.###....#........###.#.#.###......#.####.#####..###....##.###.....######.####.....######..####,#####..#.##
#.#.#.......###....#.#.#...#.########.######.######.###.#.#....##.#..###..##.##.#...#.#..#.#.#..##..#.#.##.....###..,,,,###.#..#
#.#.#####.#.####.#.#.#####.###.#......##.....###....##..#.####....##.##..##..##.###.#.#.##.....####.#.#..#####...##.#.#,,####.##
#.#.#########.##.######.#..##..#####.#####.#.#...#.####.###....#.##..###.##.##..##..#.#..###.#.##...####.#.....######.##,,######
#.###.........##.#........####..#.#..##.#..###.#.###....#...#.##.#####....#.###.###.#.##.#...#.#..#....###.#.#......#.###,,,,..#
#.##..#.#####....##.##.#.##..##.#.#.##..#.###..#...#######.##.##.#.....#.##.#...#.#.###..##.##.#.###.#...#####.########...##,###
#..####.#.###.#.#####..#####.........##...#...###.##.......#..#####.#.##.##.#.#.#....##.##..##.#.##..#.#.##.#.......##..#..#,..#
##.#....#.....####.#######.####.##.#.###.##.#.#....##########...#.#.#.#..#..#.#.##.#..#####.####.###.#.#.#....#.#.#..##.#.##,###
#..#.##.##.#.##.................#..###.#..#######.##..........###...#.##.##.#.#.#..##...##....##.#...#.###.##.#.#.#.##..#.##,,.#
##.###..#..#.##.##.#.##.#.#.#.#.##.##....###.##.#####.###.###...##.##.#..#..#.#.####..###..#.##..#.#.###...##.#.#.#.##.##..##,##
##########.#.##.#..#.#..#.#####.##.#####.##......##.#.###.##..####.####.#####.###.###..##.##.#..##.#...###.#..###.#.#..##.##.,,#
#........###.#..##.#.##.#.#..#..#..#.....#######......#....##....#....###.##..##......#####..#.##..###..##.##...#####.#####..#,#
#.#.####.....#.##..#.#######.#.###.###.#.#.......##.#.###.####.####.###......##..##.#..##...##.###.##..###.##.####.##.#...#.##,#
#.#.#....#.#.#..##.#.#.........#...##..#.##.#.#.##..#.#...##.....##...##.##.####.#..#.####.##..#....##.##..##..##.......#.#.##,#
##############################################################################################################################,#
