# ##############################################################################################################################
# ## # ## # ## # ##  ##    ## #   ## ## ## ## # ## # ## ##       ## ##  ####   ##      ##   # # #    # ##    ## ##  # # ##  #  #
# #            # #  ######    ## ##   #  # ## # #          #### ##   ##  ##  ###### #######   #   ####  # #####  ## # # ### # ##
#   ## ## # ## # ##  ## #####  # #  #   ##  # # ###### # # #     ### ## ##  ## ##   ###   ###   #    ##   # ##  ##       ##    #
# # #  #  ####      ##      ## # ## ###  # ##   # #  # # # #####  #   # #  ### ####   ###     # ### ##### # ## ##  ## # ##  ####
# # ######## #### ######## ###   #### # ## #### # ## ### ###   ## ### # # ## # # ### ## #### ## ### ## ## # ##  ## ######## # ##
# # #        #     ## # #  # ## ## #  # ##  ##    ## ##  #   #  #          # # # # # ## ##   ####   #  ##    # ##  # #  ##  #  #
# ########## # # #      ## # #   # ## #  ## #####     #########   # # #### # # # # # ##  ##### ####   ##### ##  # ##   #### # ##
#  ## #        # # # ##        #    # ## #  #  ##### ## # ###### ######    # # #     #  ##  ##      #   #   ## ## ## ### ##    #
# ##  ####### ## # # ######## ### #   ## ## # ## # # ## # #  ######  ### #   # ##### # #### ####### ### ### ##     #        ## #
#  ##          #####  ##      # #####     # # ## # # ## # ##  # # ##   ##### #  ###    # ##  # #  ##### ##   # ###   # ## #  ###
# ##  ## # # # ## #  #### ## ##  # ### ##            ## # ###     ### ####     ## #### # #  ## # ####      #     # #############
##### ##########  ####    #   ##       ## # # ## ###       #  ###   # ## #####  # ###      ### # ## #### ##### #######   ### # #
#   # #     # ### # ####### ##### ## #  ### # #  #   # # #   ##   #          # ## # ### ####   # ## #  #### ##   ##  ###  #  # #
### #######             #####     #  ## #   ###### # ###### ##### ### ######   #     ## # #### #  # ##  ##     #####  ## ## ## #
#    ## ##  # # ####### # ##  # ######  ## ### ######## ######    #   ##  ####   ###    #  # # ## #  ## ##### ## ##  ##  ##  # #
#### ## #  ## ########     ######      #####      # ##   # # #### # # ### #  # ### #### # ## # ## # ##  # # # ##  ##  ##  # ## #
# #     ####  ##     ##### # #  ######## ##  ## #   #### # #  ######### # ## ####       #  #   ##   ## ## #    # ##  ### ##    #
# ##### #  #########     #   # ## # #### ### #  ###    #   # ## ## # #        # ### ### ##   ###### ## #  ## # # #  ###     ## #
# # # #   ## ## ## ##### ### # #         # ########### ###    # ##     ## # #   ######   ## ####    ## ## ## # # # ## ## # #####
# #     # ## #     # ##   ## # #### #### # ##  ##  ##  # #### # ###############   ## ### #   # ####  # ## ## ###         #######
#   ### # #    # #      #  #    # #####     ## #  ####    # #   # ## ## ## # ### ##  ### ## ## ## ##    # ##  ### ### ##### ## #
# # ##### ### ###### ##### #### #  ## #### ##  ## ## #### # # ### #  #  ##        # ## # #   # ## ##### # ### # # # #####    # #
# ### ### # ##### #### # # # #  # ##    ##  ## #        #      ## ## ## ## ## # #          ### #  # ##    #          ##   #### #
# #       # ## #  # #        ##    ### ##  ##    # ####   ####        #  #### ####### ####  ## ## #  #### ## ###### ##  #  ##  #
##### # #    # ##     ## # #    # ## # ### ########## ### ##   ### ##   ###   #       #####  # ## # ## #   # # # ##### #####  ##
## ## #### #    ## ##  ######## #           ## ## # # ##  #############   ########### #     ## #  # ##   ### # # # # #    ###  #
#  ##### # #### ######### # ##  ## # # #### ##        ### #      #### ## ###      ######### ## ## # ## #   # #     # # ####   ##
# ## ##    #    #    # #       ####### ##    ######## # ######## # #     # ###### #   ##       ## #  #### ##   ##### #    ###  #
#  # ######## #   ##     # # #  ##     ## ##     #### # ##   # # # ##### #  # # # # ###  ##### #  # #####  ## ## ### # ####   ##
## # # # ##   # ###### # ##### ##### ######### #    # #  ###   #    #  # ## # #      #######     ## ## #  ##  ## # #    ##  #  #
#           # ###   #######    # # ##### # # # ## #     ## ### #### ##   ##     # ## # ##  ##### #  ## ##  ##      # ####  #####
# # ## ## # #######   # # ###### #     # # # ####### ## ## # #  ##  #### ### # ## #    ### #       ##   # ##  ####        ## ###
# # #  #  # #    ## #   #        ##### # #    ##  ##### ## # ##  ##   #    ### ####### #   ### # #  ### #  ## # ### #####      #
######### ######    # #   # ## #       # ####  # ## ##  #       ##  #   ######## ##    ###  #######   # # ###    ###### ### ####
#  # ## #### ###### # ## ########## ##   ## ##      ###   # ###    ####      ##     ## # ## # ##  ### # # # ## # # #  #  #### ##
##   ## #           # #### # ## ####### ##   ## # #     # ###   #### #  #### ########     # # ### #     # # ## ### # ## ## #   #
####      ## ### # ####       # # ## #   ###    # ## # ## #   ### #    ##### # ## #######      ## ### #   # #  ##    ##      ###
# #### # ########### ###### #          #     # ############## #   #### #        # # #     # ##  # ####### # # ##  ####  # ##   #
#      ### #   ## ## # # ###### ### # ##### ## # # ##### ########      ## ##### # # ###########   # ## ##        ##    ##### # #
## # # #     #                  #######      ### # # # #  #  #  ##### ######    # # # # ####  ###   #  #  ######    ##     # ###
#  ###### ## ## ################# ###   ## # #     # # ## ## ## ######## # ## #         # #  ###### ## # ## #  ####  # #########
## ## # ######### ## ## #    #      ############ #                  ## # # ############   # ##   #            ##### ######  #  #
#  ##    # #      #     #### ### ##  # #     ##### # ########## # #      # # #          #    ### ####### #######  #  ### ##   ##
####### ## ## ### ## ## ###  ####### # #### ## ######## # # #   # ######   # ###### # # # ## ##             ## # ##### #    #  #
# ## ## ##  ### # ## ## # # ##  #  #    #   ## # #            # # #      #          ######## ###### # ### #    #    ##   # ### #
#    #  ### ##     ###      ### ## ## #   #    # ######## ## ############## ###### ##               ###   ####   ###### ########
#### ##   # ##### ###  # ##           ## #####    ###     ##  #######     ####      ##### # # ##### #   #   ####### # #    ## ##
#       #     #   ##  ############ # ############     ## ### ## # # ##### ##   ### ##     #####     # # # #  #####      ####   #
# # # #### ## ###    ## #          #  ##  #       ### #  ##  #       # #     # #   #  # # #     ## ## # # ##       ## #      # #
######## ###      ####    # ## # ######## # # # ###   ## ## ##### ##     # # # # # ## # # # # ###   # ###  ## # ################
#         ############## ##  ###### ## #    ### #   # ##  ### ### ## # ### # # # # ## # # # ###   ### #   #####            #   #
# # # # #   ##           ## ###      # ####   #### ## #####       ## ######### # #  # # # ####### ###### ##     # ########## ###
# # #######  ##### # ## ##### #### #        #### #  # # ###### ########        # ## ########  ###   ##    ## # ##        #     #
#######   ## #     # #   ##        # ## # # #      ## #        ### ###  # # # ## ######      ##   #  ### ##### ### ####### #####
## #    #      # # # ###  ###### # ###### # ##### ### ########## # # ## #######  #      # ##    # ##  ## # ###   #     #    # ##
#    ## ##### ########   ## ##   ##### ######## ### ### # # #           ###     ## # ## ##### # # ## ##      ## ## # #   ##    #
# # ##### #    ## #    # #     # #      ## ##    ## ##        # # # # # # ### # ## # ####     # ######## # # #  #  ########### #
# # ## #    ####    # ## # # ##########    #####     ##### # ## ### ##### #   #  # # # ###### ###        ### # ###           # #
#####    # ##    # ####### # #          ## #     ## ####   ########### #    # # ######        #   # ## #  ## # ##  ## # ########
## ### # # ##### ### ## #  ######### # ##    ### ##    ### ##            # ####  ##    # #### # # ###  # ##  # ###  # #       ##
#      # # #     ##       ### ####   # ### # ######## ##   ## # # ## # # # #    ##### ## ###  # # #   ##  # ####   ## ## ####  #
## ## ######### ##  # ## ##        # # #   ### ###       # ## ### #  ### # ## # # # ###  #   #### ### ## ##   #### ## ##    ## #
#  #  #         ### # ## ## # # # ## # ### #       ### # # ## ##  ## ##  # ## # #       ####  ######   # #  ### ##  #### # ##  #
## # ## ##### # #   # #  ## # # # ##################   # #  ######## ## ########## ## ### #  ##      ###### #      ##    ##### #
#  #### #     # ## ########## ##### # ## ## #        # # ##   # #     ####   # # ####  ##   ### # ##   ##   ## # #  #### ## ## #
## ## #### # ########  ###    ##              # #### # # ## #   ## ##### ###     #    ##  # # # ###  ######  ### ## #       ####
#  #  ## #####    # ## # ######## ## #### ## ####    # ###### ######         ### ####  # ## #     ##     ### ##  ## ### # ### ##
# ### #  ########         ## ## ######    #### ## ## # ##     # # ### ## # ###        ##### ## # ##  # ###    ## #####  #      #
####    ## # ##   #### ## #     ######## ## #     #  #  ## # ##       #  # #   ## # #  ##    ### ## ##   #### ## # #   ### #####
## #### #  #  ## ######## ##### # ## # ###    ## ### # ##  # #  # # # ## #### ##  # # ##  ## #    #  # ####    # # ## ##      ##
#       ## ##  # ##  ##                ##### #####   #  ## ###### ### ##### #### ## #  ## #  ### ## ####    # ####     ### ##  #
# #####       ######  #### # # ## ####   ###   #### ## ###### #   ##   ##    #   ## ####### #### ##    ### ##  ### # ####   ####
############# # ## ## ###  ############ ##   ### ## ## ##       # ######  ##   # ## #   ######    ## ###    # ##   # #    #    #
#                         ##               # ##      #  ### # # # #      ##  ### ## # #      ## # #   #### ## ## # ##### ### # #
## ####### ## ###### ## #  ## ## ###### ## # #  # # ## ##   # # # # ## ##### #   ## # ## # #    ### #  ###  ###  #  # ##   #####
####       #  #      #####  ######       # # # #### ## ## ##### # ######     # #  ########## ## #   # ##   ##### # ##    #### ##
# ### # # ### #### # #     ### ##  # ## ######## ##  #  # #  #### ##  ##### ##### ## ## #    #  # # # ## #  # #### ### #       #
#  ##############  # # # # #   ### ###   ## ##      ## #####  ##  ###    ## ##    #       # ### # # #  ####      # #   # # ### #
# ## # #   ##     ## ### # ###     ##  # #     # # ### ##  # ##  ##   ##     #### # ## ## #  ## # # ##   ## # ## # # ### ###   #
#        #    # # ## #   # ###### #### # # ### # #   #  ##      #####  ## # ##    ###  #  ## ## # # ## #  ###  # # ####    ### #
# # # # ### # # # ## ### ###        ## # ###   # # # # #### ## ##     ##  #  #### #   ###  #  # # #  # # ##   ## ####   ##  ## #
# # # # #   # # #  #####   # # ## # #  # ##  # # # # # ##   ##  ######### ####  ########## # ## #### # ##### #####    ###  ##  #
# # # # ### # ### #### ## #### #  ### ## #  ## # # # #  #######  ## #  #   ##  ##      # # #  #  # # # ##        ####  ### ## ##
# # #####   # #   #          #### ##  ##### #  # # # # ##     ##### ##   #####  ###### #   # ## ##   #  ### # ####### ##    #  #
#####     # #### ## # #### ###     ##   ##  ## # ### ###### #          # #   ## # # ##   # ######## ### #   #####      ### ## ##
#     # # #  ##  ## # ###   ##### ##  #  ## ## ###   #      ## ##### # #####           # #      ##  #   ###     # ### ##   ##  #
####### ### #### ######   ###     #  ### ##### #### #############    # #     #### # # ## ### # #### ## ##   # # ###   ####  ####
#       #   ##   # # ## # ### # # ##   ###       ####           ########### ### ##### ##  ####  ##   ##### ######## # #    #####
########## ##### #      # #   ### ### ####### #### ## # #######   # # # # ### #       ## ## ## #### ####    ##    ### # ##     #
#          #     ## ## ## ## ##     # #        ##     # #       #               # # # ##     ### #####   ##    ## ##  #### #####
##### ## #### ## ####   #  #  ## ## ##### # ##  # ### # ## # ## ## # # # ### ## ### # #  # # ##        #  ## # ##########   ####
#      ###    #  #    ### #########   ##### ## ################### # # ####  #  #   # # ## ##### ### # ## #  #   ##       #    #
#### ########### ## # #    ###      ###     #   ### ## ## # ## #   ### ##   ### ### # #  #    ## ##  #### ## # #  ### ## ## # ##
#     ##         ######## ## ### ######### ###### # ##           # #   #  # ##  ##  # # ## ####   ## #    #  # # ##   ## ## #  #
# ## ##### ## ####         # # # #         ##       ########## # # ## ### #### #### # # #   ##  ###  ## ###### ##### ### ## ## #
####   ##  #  ##   # #### ##     ## # #### #### ### # # ##     # # ########    ## # # # # #  ####   ### #       ## #   # ## ## #
#  # ###  ###  ### ############# #  # #     ##  #        # ##### # #   # ##### ##   # ### ##  #### ##   ## ## # #    # # ## ## #
##   ##  ## ## ##  ##   ## ## #  #### # # # #  ### ## ##   ###   # ###         #  # #   # ###    #  ## ##   ### #### # ####### #
#  #  ## #     #  ##### ## #    ##    ### #######   ###  ###   ######### # # # ## # ### #  ## # ### #########   ##   #       # #
## # ##  ###########       ## #  ## ######## ## ## ##   ###  #### ##     # # # ####   ######  #   ###         # #### # # ## ## #
## ###  ##         #### ##    ## ## #    ##     ## #######  ##       ## ## # # #    #    ##  ## # ##  # #### ##  ##  ###  #### #
#  #   ##### # ###      ### #  ######### #  # #     #### ##  ## # ## #  #  ### # ## # ## ## ### #  ## ###     ######   # ### ###
## ## ##     ####  # # ##   ######         ## #### ##       #######  ## # ##   # #  #  #  # ##  ####  ##  # # #    # ### #     #
################  ## #  ## ##    ############## ######### #   ## ###  # #  ### #### ## # ###### #    #### # #### #    ##   #####
# ## #           ##  ## ## #### ## #  #             ##    # ###      ## ##########   # #  ######## # #    # ##   ## #### #     #
#  # ### ## # # ##  ##  ## #     # ## # # ##### # ###  ## #   ## # #  ####         # ####   ## # ####### ## #  #### ##   #######
##       #### #  ##  ####  #####        # #     #  #  ##  ## ### ####    ######### #    # ###            ## ######  #  #  #### #
########  ##  # ##  ######## ### ### # ## # # # ##   #### #  #   ###  ## #         ## # #   ### # # # ##  # #      ### ##      #
##       #### #  ## #    ##      #   ###  ### ###  #  ##  # ## # #   ############ ##  #### ##   # # ##### # ## # #  ##  ## ## ##
#  # ## ##    ##  ######  ###### # #   # ####  ### ##  ## # ## # # #    ##         ##  # ###### # # #     # ## # # ### ##   #  #
# #####  ## # ###### ####        # ## ####    ## #  ##  # ######## ### ### ##### #  ##   ## ##  # # ##### # ## # #   #  ## ### #
#####   ##  ### # #       #### # # ######### ##    #### #### #     ##  ##  #     ## ## #     # ########## ###  # ## ## ##  # # #
## #  ########      ## ## #    # #  ## #  ######## #  #####    # #  ########## ###  ## ###########          #### ## ## ## ##   #
#    ##  #     # ##  ####### # ### ##  ## # # ##     ##     # ## # ##### ### # ##  ###         ##  ###### ###    ## #  ##  # # #
## #  ##   # ########## ##   # ##  ###        #  # # ## ## ## #  ###           ## ##   ## ## #######        ## # ## ##  ## ### #
#  # ####### #### ## #     # #  ## # ##### ##   ####  ###   ####   ## ### ### ### ## #  # ##    ###### ## ###  # ## #  ##  #   #
## # ## ###### #       # ##### ##  #  # ####  #    ## ##  # #    ###### #  ##   ###### ####  ####   ## ## ########  ##  ## ### #
#  # #     ##  ## # # #####    ## ###    ######## ##   ## #########  #    ##  # ##       ###  ##  #    #    #  ##  ##  ##  ### #
#### # # # ###  ########  ### ##### #### #  ###   ## ####### #  # ## ### #### #  ### # #  ## ####### # ## #   ### ### ######   #
#    ##### # ##    #   ##     ##### # ## ##     # ##   ##  # ## # #       ##  ####   # ##  # ##### # # #  # #   # ##   ##    # #
## # #          ##   #    # #  ##           # # #  # #  ##          # # #  ##  ##  # #  ## #  ##     # # ## ## ##  ## #### # # #
############################################################################################################################## #
