# ###################################################################################################################################################################
#  # ##  ## ##  # #  ##   #  ## # #  # ## #### #   ## ##    ## # ## #                 #   ## ##  ##  # #  # ##  # # # #        #    ## # ## ##   #  # ##  ##     #  #
## #  ## ##  ## # # ##  #   ### # # ##  #  ##    ####  # #####   ##   ## ####### ## ### ####    ##  ## ##    ## # #     #### #   ####          ### ## ## ####### # ##
## # ###  # ##  #    # ####          # ## ##  ##### ##     # # ##### #######   #  #####  ##  ##  ## ##    ####  # # ########## #### ### #########     ## #  ## # # ##
#  # ##  ## ## ## ####   ##### # ###       ##   #    ### ###    # ##  # ## # ### ##   # #### #####   # ####  ##            ###### #  ## ##    # ## ##### # ##       #
## #  ## ##            #    ######## ## ####  ### ####    ## #### ### #        ##### ##  ##  # #### ## # #  ##  # # ######   ## # # ##   ## #   #  # # # # ## # ## ##
#    ##     # #### ####### ## # #  ########  ##    ##  ##           #   ## # #### #     ####   # ## ## # # ### ######   ### ##      ### ### ##### ## # # # #  # ##  #
#### #### ########  ######### # # #### ## ##  ### ##  ###### # # ##   ###### ## # ## ####    ###  # #      # # # # ## ### #### ###### # #    # #     # # #   ###### #
#     ##         ##    #  # # #    # # #   # ##      ### #########  #     ####    ##  ###### # # ##   ####                 # # # # ## # # #### # ###       ### # ####
### # ## ############ ## ## # # #### # # #      ## ### # # ########## # #    ## ###  ## # ##   # #  #    ## ################ #               #     ### # #          #
#####  # ### ### #######  #   # # ## # #### ## ##            # # ########### ##   ##      ## ### # #######         ### # ### ## ###### # # #   # #   ### ## #########
# ##  ## # #      #  # ##   ###    # #  # # ##### ## # ####### #      ######### ###### ##### ###       #### # # #### # # # #  #     ############ # #   ###      #####
# ###  # #   ###### ## #  ### # #### ## #     # ######           # #### #   ##    # #            ####### ## # #   #      # # ## #####  ## # ######## ####### ####   #
# # ##     #####  #      ###  #  # # ## # ###    #  ##### ## ## ##### # # ##### ### # ##### ####          # # # #   # #### #       #  ##       ####### # ######## ###
#      ###       ## ###### ## # ## # ##    ####### ## #########   #        # ## # # #     #####  # ## ## #### # ## #### ##   ## ##   ##  # # #   # ##  #    ##    ###
### ##   # ## ## ##  ##    ## #       ## ### # #          #   # #   # # #### #      # ####### ####  #  ### ## #  ####   #  ############ ########    # ## ##    # ## #
#    # # # #########  # ####    # # ###          ### # # ## ### ## ###### ##   ###### ####  # # ### ##      # ##  # ### # #### ## ### # # # # ## ##       # # ##  # #
### ######## # #  ## ## ## ## ########  # ################# # ###### # #   ## ##   #     ##       # ## # # ########                            #  ## ############## #
#        ###   ## ##  #            #   ##    #      ##  ##     #   # #   ###  ## ### #####  # ## ## ## ##### # ###  ## # ### ##### # # # ## # ###  #        ### #   #
## ####### ## ##   ## # #### ####### ##### ### ######## #  ###   # # ## ## ## #  # #  ## # ##  #  # ## ###   # #   ##  #   ###############  #  ## #### ###### #   ###
#  #### ##  # #  ###      ##    ## #    #### #       ## ##   ####### ##  # ## # ## # ##    ## ## ####    ## ##   #  ## # #  #     #  ###########     #          #   #
##    #  ## # ## ### #### ## ####    #### ## # ## ####   # #### # #   ## # ## #         # ###### # ### # #     # ##### ### ## ##### ## # # # #### # ### # # # # # ###
#  #### ### #    #      ####  ##  #####    # # #### ####     #      ###         ## # ###### ## ###   ###   # ####### #  ##     # ##             # # ##  # # # # #   #
# ### # # # ## ### ####### ##### ## # ####       ##  # ## #### ###### ## ## ## ##  ##### ##        #########         ## ## ###      ########## ######## ########### #
# ##      # #         ###    # #       # # ### #  # ##          ### # #  ####   ##  ##    # ### ##         ## ### ##### #    # # ##     # # #### # ## #  #       ## #
# ### ##### # #######     #### ## #### # #   ###### ### #########       ## ## #####    #### # ###### # # ####  #####  ### # ## #  # # #       #     # #### # # ######
#  ##  # ##       ##### ###  # #   ###     #######   #            # # # #   #### ## ##  ### #  ## ######### #### # # ######  #### ### ######### ##### #### #######  #
# ####    ## ## #    ##   ## # # ### ### ####  #   #   ## # ###########   #  # #  #####     # ##    # # ##  ###           ######    #  ###### # # # #       # ##   ##
#  ##  ##     ######### #### # #     ###### ## # ### #  # #    ### # ######### # ### ## # #      ####    ## # # # # # ######## #### ##      # #       #####      ####
##    ########## ## # ####   # # ###    # #       #### #### ####   # # ### ##         ##### ### ##  # ####      ### #   ###    #  #  ## ###     ######### # ### ##  #
#  #####  ###          # ###      #####     ## ##  ##### ## ###  ###          ## #######  #   ###  ## # ## ## #  #### ### # #### ### #    ## #########    ### #### ##
##   # # ##   ##########  ## ####    ############### ###  ### ## # # ##############  # # ## #  ### ## #  # #####  ######  #      # # ## ########       ##      ##   #
#  #        #          # ##   ######## #### # # ## # # ## ### #         #### ## # # ##    ####      # # ##    ## ## ## ## # ####   # ####      ## ####  ########  # #
## ## ## ####### #####      #    ##                    #        #### ##              # ##  ########        # ##  #           ######### #  ######     ###### ## ## # #
#  ##  #      ######### # # ####    # ## ####### # # #   ############## ### # # # ##    ##  #     ### # # ##  #### ###### ##       ##    ####    ###### #    #    ###
##  # ## ###### #     # # #    # ######### # ####### # #       ##     #   ##### # ### #  #### ###   ######## ## ##  #  ##### ## # ### ####    ######  # # #### ##  ##
#  ## ##        # ####### # ####    ## ##          ### ## # ####  ## ### ### ## #   ####  #   #### ####  # ####  # ## ## # ######## #  ######      ##       ##  ##  #
# ##  ## #### #         ###    ## ###     # ## # #############   #########   ## # #    ##   #    #### ##    # ## #  #            ## ##   ##   ####### #####    ##  ##
# ## ##     #### #### ##### ####      ## ##  ######  ##### # # ###    # #  ###### # ####### ########  ## ##   ## # ## ### ##### ##  ### ### ### # # #     ## #####  #
#  # ### ##  # #########  #    ## #####   ##  # # # ## ##  #     # #### ## ###  #######   #  ## ## # ### ######         #    ##### ## # ##            # #  #### ### #
# ##  ##  ##    ##       ## ####     ########## #       ##   # ### # ## ##   # ###      # ##  # ## # ##     ### ############## ##  #       # # # ############ # # ###
# #  ##  ##  ##    # # ####    ## ##       ##     # ###### ###           # ### # # ### ######           ##### # #      ##   #   ## # ####### # #          ##        #
# # #### ## ##  # ####    ### ###  # # ###    ########      ## ##### # #       #     ###### ## ## ## # ### ## #   # ##  ###   ###          ###### # # #####  ### ####
# # ####  #  ## ###    # #### ##  ## #   ## ### ## # # ## #  #    #### # # ## ## ###### # # ##### ## #          ######### # ####  ## # #######  #####       ######  #
# #  ##  #####    ### ## ##   ## ###### ##              ###### ##   #### # ##### #              #  # # ###### #### ## ##  #    ##  # #    ## ## ## ########### ##  ##
# ##  ##     ## ### ######## ##    ## ###  ## # ##### #     ##  ## ## ####         ######### # ### # #      #          ## # ##### ##### #  # #     # ##### # # ### ##
# ## ##  ### ##       #   ##  # ##      ## #  #  ###### # #  # ##        ### ### #        #######  # ## ########## # #  # # #         ###### # ###              #   #
#  #  ##  ###### # #### #########  ## #### ## # ##  ####### ##  ########  ##  ## # ######   # # ######          #######       ###########        ## ## # ## ###   ###
# ## ####      ###           ##   ###### ###  #    ##     #  ##        ##  ##  # #    #### ##       ## ### # #### # #### ## #      # ## ## #######   ### ##  ## #####
#  #   ## # ##   # # ## ####  ###    #    ###### ###  # ############ ##### #  #### ##   ##  # #### ##   ## #      #  ##   # # # ##             # ### #######  #     #
## # ###  #  # # ###  #   ###  ## #### #### ## #     ##        #####   # # ##    # ## #  ##     ####### ## # # ##   ### #########  # ### #######   #   ###   #### ###
#  #   ## ## # #   # ## #  ## ##               ## # ### ### ##     ###   # ## # ## ##### ## ###       # #  # #  ## ## ###       ####   #         # # #   ### # ##   #
########   ##### ### ##########  # # ## ## # ###  #   ######### ## ### # # ####  #     ####   # # ####### ## # ##         ### #   ## # # # ## # ###### #  #### ## ###
####     #   ##  ### # # ## #### ######  # #  ## ######## ## ####    #####    ########  ##  # # #       ###### ## ### # ############## # #### #      ### ## #  ##   #
#    ## ## # ###   #          ##### # #### # ###   # ## # ##    ## #### ########     ##  ## ######## ##     ##  #   # #   #   #### ##  #    # ## ####### ##   ##  # #
## # #  ## #   # # ### #### #            # ###   #         # #####        ##     ###  # ###    #  ####  # # ## ## ##### #   ###     ## # ######### ##  #    # ## ## #
## # ## ## # # # #   #    # # # # # ######   ### ## #### #       # # # # ##  # # ######   ###### ## ##### ###  ##    ## # #     # #### #   # ## #     #### #####  # #
#  # ## ## ### #### ## ## ##### # ########## #   ##  ##  # ######### ###    ####      ###  ## ## #   #  ##### #### ###### # ######## # # #        # ######     # ####
# ## #  #   ##  # ###   #### ####        #######  ##  ####         #   ## # #  # ####   ##         ### #### ### ## # # ####      #   # # ## # # ######## ######### ##
#  ###### #####     # #  # # # ## ## ##### ## #######   ## # ## ##### ##  #   ##   ### #### #### #      # # ### ##      ##  # ##   # # #  ### #     # #         ##  #
####       ## ## # #####        ###         #   ### # ###  #  ############## ##  ### #   ##    # # # # ##        # ### ### ## ############### # ##### # ## ####### ##
#    # ###    ## # ##    # ####   ## # ###### ### # #  ### ##  ##  # #    ##  ##     ###### ######## # ## ## # ###   ####   #   ## ## # # # ###    ## #  ### ## #   #
# # ## ##  ####  #  # # ##    # ######      # ##    ## # #  ##  # ##   ######  # ######   #        # #     ###   # ####   ### #              ## ##      #### #    # #
# # #   ##    ## ## ### #######     ## # ##      ##  ###   ####      ### # ### #        # # # # ###### # #   ## ##### ###  ## ### ### #### # ##  # # # ##  # # ######
# # ## ### ####   # ##        ### ###  # ### #######  ####  ##  ####         # ###### # ### # #  # ##  # # ###     #    # ### #####      ####### #####  # ## # ### ##
# # #  #     ## # ##### # ###   #  ## ##   #       ##    ##  ##   ################### #   # ####    ## ########## ## # ## ##      ### ##      ##   ##  ## #         #
# ####### # ##  #     ### ##### ## ##### #### # ###### # ## ### #           # ##    # # ###   ## ####    ##   ##   # ########## ### #  # ## #### # ## ##    ## ######
# #       #  ## # ## ##       # ##     #    # #      #####    # ## # ## ## ## #  # ####  ## # #     ## #    #  ## ##  #   ## ## #   ## ########  # #     # ###     ##
##### ## ## ##  # ##  ## ## ###  ## # ### ### ## # #  # ####### ## # ########   ##    ####### ## ####### # ########  ## ###  #### #### ## ### ####### # #### ### #  #
## #  #  ##  ## #  # ##  ##   ##########   ## #### ##        #######   ## # # ##########    ####    #  ########  ## ##    # ##  # ## ###    #     ##  #        ######
#    ### ## ##  # ##  ## ### ### # # # ## ##    ##  ## ## ##   ##    #                 # ##### ####   ##  # # # ##     #### ## ## #   #  ##   ####### # #### # ## ###
## # ##  ##  ## #  # ##   ##            #  # ##  ##  #### ## ####### ## # # ### ## ###       # #### #  ##     #  # ### ## #         #   #######   # ###    ###      #
## #  ## #  ### ## # ## # #  # # # # ## ########  # ### ###      ##  ## ### ###  #   ## # ##      ####    ##### ##   ###  # ##### #### ### ###  ###   ### #### # ####
#  ## ## ## # #### # ## ### ## # # #  #   # # ##### #    ####### ## ##   ##   # ## ########## ###### ####          ###### #   ###  ##          ## # ###      # #    #
## ########      # # ## #    ##### # ####        ##   # ##   #####  ####  ## #####  # ## ##     ##      # ## ## # ## # #    ### ####  # ### ##  #    ##### # # ## # #
#  # ## #   ## # # ###  ### ### ## #    # ## # #  # # # ## #    ###  ##  ##  # # #### #   # # #    # #### ####  #        ##      #### #   #  ##   ##     #######  # #
# ##      # ######  ## ##        ### # ##  ### ## ### #    # # ##   ####  ##     ## #   # # # ######    #  ### ## # ## ####### #    #### ####### ##  # #       #### #
######## ##   ########  ## # # # ###########    #   # ## # # # ### ##  ##  # # #      ##### # ######## ## ##   ## ####       # ###########   ##   ## ### ####### ## #
## # ### #  #  # ### ####  # # #          #### ### ##  # # ###   #  ## ## #### # ## #    ## #        #  #  ###  # #    # ##########   # ## #  ## ##    #         ## #
#        ## ##        ##  ## # ## # # ##### ##   # ### # #   # #######       ###  # ## #### # #### # # ############# # #            ### ## ####   ### ## # #### ##  #
## ## ##### #  # ## #  ## ######  ###   #   ### ##  ## # ## ##     ##  ## ###########     ############## #     # ##### # # # # ## #  ## #   # ## ######  #    ###  ##
####    ##  ## #  ### ###    #### ##  ### ###    # ##  #### ## # #  ## #   ##   ##  ## ##          #####   ###    #  # # #####  # ##      #    #      #### ##########
#    ##  ## #  ##   # # #### #    ###      ## # ######    #  ### # ### # #    #    ############ #### # ## ######### ####     ## ###  # ## ## # ### ##    # ###  ### #
### ####### ####  # #      ##### ##   # ##### # # ## # # ## ###  # ##  # # # ####### ## ## # ##### # #        ##      ## # ###    ## ###   # ######### # #     ##   #
######        ## ## # # ##   ##   ## ##     # #    # ######## ####  ## # # #                   #     # ## # #  ## #####  ####### ##    # # #      ## ####### #  # ###
# #    ## ## ##  #  # #### ##### ##  ## ## ## ## #            ##### #### # # ### ##### ## ## #   ###    # ####      ####       # ### ##### # ## #     # # #####   ###
# #### ##  #  ## ## #    #  ##    ## ##  #  #  ### ###### # #    ##  ##  # # ##      ######  # #   ## # #  ##  ## #   ### ######   #     ###  # # # #         # #   #
#      ## ## ### #  # # ###  # # ### ## ## ## ##        # ### ##  # #### # #  # ## ####  ######### #### # #### ## # #   #     ## # # ######  ## # ### ## #### # # ###
## # # ####    #### # # # # ## # #    #  # ## ## ## ## ## ###  # ## #    # ## ####  # ##       ###   ####   ## ## #### ### #########  # # ##  ###   # ##   ######   #
#  ###    ## #  ##  # #   ###### ## ### ##  #  #  #  ###    # ## #### ## #  # ## ##      ### # # ##### ######  ##   ##  ## ### ## ## ##    ##   ##### #  #   # ######
## ##  ## ## ###### ### #      # #    # ## ### ## ##   ## # # ##   ## ## ## #     ## # #   ###    # #       ####  #### ##         ##  # ####  #     # ## ## ##      #
####  ##  ##  ## #  ##  # ######## # ####  #####  ## # ###### ## ###  #  ## ## ####### # # ### ##   # #####    # ### ##### # ## #####      # ### ## ###  ##    # # ##
#    ####  ##    ##  ## #   #   ## #    ##  #  ## ####   # ##  #   ## # ###### ## #  ####### #### #      #### #####    # #####      ## ####### ###    ####  ## ######
### ##  ##  ## #### ##  # #   # ##### # ###   ##    ## #    # ## # ## ###         # ##  # ##  # # #### #    #  ## # #### ## #  ### ##      ###   ### ## ## ##       #
#    ## ## ##   # # ### ### ###    ######   #  ## ####### # # #  #  # #   ## # ##    ## # ## ## ######## ######## #         ## ##   ## ## ##   ### ####  ##### # # ##
## # ##     ###   #   # #   ### # ## ###### ####        # # # # ## ##### ##  # ## ##             ##  ##### # # #    ##########  ## ##   ###  ###    # # ### #########
#  #  #### ##   ######### #   #####   # ##     ### ### ##########   ##    ## # ## #  # ## # # ####  ## ##  # # # ##        # # ##   # #  ## ## # ####         #   # #
# ### #     # #         # # #  # ## ### ### # ##   ##### # #   ### ##### ##  #  #### #### # #    ##     # ##      ########## ######## ##     # #    # ### ###   ### #
####  # # # ### # # # # # ####            # # ## #     # #   #   # ## ## ### # ### #    ##### ##    ##### ### ######     ##         # #  # #     ####   #   ##### # #
## # ######  ## ##### # # ## # #### ## # ## ###  # # #     ##### ###      #### ##    # ### ## ## ##        #   ### # #####  ## # # ## ## ### #######  ### #         #
#      ##   ##     ########      ####  # ##  ## ## # ### #  # ####### # # #    ## ## #      #  #  ########   # # #         #############  ##  ####   ######### # ## #
## # #  ## ##  # #     # ##### #   ##### ## ###  # #   ####     #  ## # # #### ####  # # ## # ###        ## ## #   # ## #####  ###   # ##  ##    ## ###     ## ######
#  # # ##  ### # ## # ##  #### ###    ## ##   # #### #   ### ##   ### #####      ## #### ###### ## # ###  ###    ########## # ## ## ## ####### #      # ### ##      #
## # #  ##  ## #  # #  ##        # ## #  ## ### #    # #  ##  ##### #   ####### ###   ##         ###   ##   ## #     # #          #      ## ####### #    ##### # # ##
#  ### ##  ##  # #######  ## # #########  #  ## ## # ########   #   # ### ###     ## ##  ## ## #  ## ###  #### # # #     # ## # #   ####      #   ### ##   ##  # #  #
# ##    ##  # ## # # ##  ### #       # ########### #       ## #   ### # #   # ## ###  # ##   # # ##    ##  # ### #### # ##  ### # #    ######## ###    # #### #######
#### # ##  ## ##      ##   # ## # ##       ### #   # # ######## # # #   # #    # #   ##  ## ## #  ## # ###    ##    # #####  ## # ## #          # ### ##### #    ####
#    #  # ##  #  # ##  ## ## #  ##### # ##   # ## ####      ### #   # ####### ## ## ### ##   # # ### #   ######### ##### ###### # ## # ########    ##       # ##    #
# #### ##  ## # ## ## ##  #####  #  # #  ###   ## ##   ## #   # # # #  ##     ##  #   ##### ####   ### #        ##  ###       ###### #       ## ##### # ######### # #
# #     # ##  # ## ##  ##  #####   ## # ###  ###   ## ##  ######### ## #  # # ## ## #### #  # ## ###   ##############   ### #### # #### ## ####     #######    ## # #
#### # ## ## ## #   ######   # ## ##### # ##   ###  #  ##  ###    ###  ## ### ##  #      ##   ##   ###         ##     #   #   #     # ###     # ###### #    # ##  # #
## # #  #  #  #### ### #   ###        #   ## #  ## ###  ##     #######  ###   ## ## #### ### ########  # # #####  ## ### ###### # #     # ## ##     #    # ##########
#    # ### ## #    #     #   ## ## # ### ###### ##   ##  ### # #### ## ##   #  # ##    #   #  ##  ##  ## #       ##    #        # # # ###  ###  # #   # ## # # ###  #
## # #   ############# # # # ## #  #   #     ##  ## ####   ###       #  ## ## ##### #############    ###### ### ######## ######## # #   ##   ## # ### #  #         ##
###### ##### ##        ### # ## # ## # ## ##### ### ##   #   ###### ## ##  #  ##      # # # # # ### ## ## #   ### # ############### ## #### ##  #   ######## # # ####
# # #         ### # ## ##  # ## # ## ###   ## ### # ## ### #  #   ######## ## #### ##   #       ##     ##   # ##       ##        ##  #    #  # ####### ## ######    #
#     ### ######### #   # ## ## #  #  ####      # ######   ##   # ## ## ## ##  ##   # #   ######### # #### ##    #######  # ### #### ## # ## #      #          ### ##
# # # ##    ##      #####  #  ### ###   ## ## #        ###  ## ##        # ## #### ## ### #       # #   ## ## # ######   ########  ########### ####   ### # ##  ##  #
# # # #### #### ###    ### ####    #### ##  # # # ## # #   ##  ######### #  # # #   #  ##   ## ## ### # ## #  # ##     #          ###### ## #     # #  #### ## ######
# # #   ## ## #   ## #  ## ##### #    # ## ## # ###### ### ###   ## #### # ## #   # # ### #  #  #   ######## ##  # ## ## ## # ###### ##   # ## # ## ## # ########   #
# # # ###  ##   #  #### ##    ## # # ## #  ## #      ###     ###       ### ###### # # ##  # ###### ###### #   ## # #####  # #   # #     # # ######   #    ## ## # ###
# # #  ## ### # ##### # ## # ##  # #  ### ### ########## # #  ## ## ##   #  ##    # ##### #  ### #  # # # ## ##      ##  ## # ### # ####### # # ###### ####       # #
# # ##  # ##  #  ###    ## #  ## # # ####   #          ### # ### ############# ## #  ##   ##     ##        # ### ## ############       # #       # #####  # ### ### #
####### # ## ###   ## #  # # ### ### ##   # ## # # ### #   ###         #     ###  ## ####### ###### # ## # # #   ## #  ##  ##  # ####### # ####### # ##  ## # ####  #
###     # ##   ## ##  ## # #   #   # ### ####  # # ##### # #### # # ##   # #  ## ##    ###        ###### # # ### #    ##  ####              ### ##    ##       # ## #
#   # # # ## # #  #  ##  # # # # # #  ##  ##  ## #     # #   #### # #################### ### ####### # # ### #   ### ### ## ## ############## #  #### #  # # #      #
# # ### #  # # ## ##  # ## # ### # ## ###  ##  # # ## ## ###    ###   ### # # ### #  ##           #    #  ## ### ##                     #       ###     ######### # #
# # #   #### # #   # ##  # #   # # ##   # #### # ####### ##  # ##   #          #    #### # #### ### #####  # #   ## # # # # # ## ######   #####     # #    #### #####
### ###    # # # # # #  ## # ### #  ## ####    # ## ## #  ## ###  # ## # ## ##   ## #    #   ##        ######## ##### ##### ####   ######    ## ## #### #### #   # ##
#   #   ###### # # # ##  ###   # ####     # ####       #####   ## #### #  # ## #  # # # ## ###  ## ##### #   ## # #       # ###  #      # # ######## ######    #    #
## ## #      # # # # #  ###  # #    ## # ## #    # ## ###    # ##    # # ####### ## # # #    ##  #    #    # ## #   # # ###   ########### #                 # #######
#   # ### # ## # ### # ##   ## # ####  #  # ### ####    # ## ###  # ## #     ##  ###### ## # ## ### #   # ####  ### # #   ##### # # #   # ## # # ### # ### ##       #
# # # #   #  # #   ### #### ## #    ## # ###### # ### ### #  ##  ##  # # # #  ##   ##    ###  # ##  # ###  ### ##   # ## ###          #####  # #  ####   # ## #### ##
# ### ### # #### #  ## # #  ## ######### ##         #  ## ##  ##  #### # # # #### ##### ##   ##  ## ######## ###  # # #    # #### # #    ## ## #### ### ## ##    ####
#  ## ##  #   ## # ##  #   ##         ## #  ## ## # ## ##  # ####    # # # #  ##    ##   ## #### ##            ## # # ## #      # # # ##  # ##        #  # ## ##    #
################################################################################################################################################################### #