# ###################################################################################################################################################################
# #  ##   #   ## # ##  ## # # #  ## #  ##  # ### ## ##       # # ##   ## ## # ## #     ## ## #  # ##    ##  #   #  # #  # ##   ##  ##  ##  ## # ## # ##   ## # # ## #
# # #### ## ####    ## #  # # # ##    ####    #   #  ####### #   ### ### ##    # # # # #  #    ## ## ####  ## ### ##   ## ## ##### #  ####      ##    # ###  #      #
#    #         ## #  # ## #   #  ####   ##### ###   ##  ##     ###   ##   #### #   ###### # #####    #  ## ##  #  ## ###      ##   # ## #  # # ### # ## # ## #### ###
#### ### ###########      # ### ##  # ### #   #### #### ##### ##### #####  # # # # ## ##    ##  ## ### ##   # ## ##    ## # # ### ## ## # ###### # #### # ##   #    #
#         #   ## ##### ##   ##   ##   ### ### # ##  ##  # #   ##  #   #### #     #### #### #### ##  ##  ## ## #   ## ########  ## #       # # ##    #      ###   ####
# # # ## ## ###   # #######  ## ##  ### # # # # #  ####   ### ## ## ### #    # #  # #   ## ###  ## ##  ##       ####    ######  #   ## ##     ## #### ######## ######
# # # #   #   ### #  ####### ##  ##  ##         ##  # ###  #  #       # ### #### ## # # #   #  ### ## ##  #####    # #### #  ## # #  # ########   ##    ##   #  #   #
# #######   # ##  # ## ## #     ### ##  # # ###    ##  ### ##   #### ##  ##  ###### # ##### # ## # #  ## ## ######## ## # # ##  ### ####  ##  ## ##  ##### # # ## ###
#### # ## #######    # ## ##### ##   ############# #  ##   ### ### #####    ## ###  #  # ##      # # ##   #    ## ##  # #    ##  ## # #  ##  ###  ## # # ### # #  ###
###        ##  ##### # #   # #   ###  ## # ##        ### ###    #    # ### ### # ##   ## ### ##### # ####   ####  #  ##   # ### ##  # ##    ## # ##  # # ##      ## #
# ########  ##  ## #   ###   ## ## ## ## # ######### #    #####   ####  #   #     ## ##  #   # # # #  ##  #  ####   ### #####   ###   ## ####    ## ## # ### #####  #
# ##  ## ##  # ##  ###   ### ## #   # ## # # # ###     #### #####  # ## ###   ######  ## # ###   # # ### ###   ## ###    # ## #  ### ##    ## ####  ## # # #    #  ##
# ###       ## ## ## ## ## # ## ###        # # # #### ##    # ### ##    #### ##  ##  ##    #   # #   ##   ######   #### ##  ####  #     ##  # ## ## #    #   #### ###
#     # ###  #  # #  #  ##   ## ##  # ## ### #   #    ## ####      ## ###  #  ##  ## ### # # #######    #  ### ###   ##  ##  # ## # ## ####   #  ## ### ## #####    #
######### ##   ## ## ##  ### ##  ####### ### ### ####    # ####### #  ##  ## ### ##    # ### ## ##   ####### #     #####  ## # #     ###  # ### ##  ###          ####
# #  # #     ###  ## ## ##   ## ## # # #   # #   ## ## ### # ## ## # #### ##   # ## # ##  #      ### ##  #   ##### ## ###  # # # # ###### ### #  ##     ## # ## #####
# ## # ##### # ##  # ##  ###    #      ## ## ## ##  ## # # # #         ## ### ## #### ## ## #######  #  ## ###  #   # # ##     # ####  ## ##  # ### ##############  #
#      # ##  #  ## #  # ##### #   # ####  ##     # ##    # # ## ### #####  ## #   ##  #   # ## #  ## # ##    ## ## ## #  #####    # ## ##  ## #          ## # ###  ##
## ### # ### ## #    ##  #  ####### #  ## #### #    ### ##    # #    ##   ##    ##### ###   #    ##    ### ###  ## #  # ## #   #### #     ##    # ## #####      # ###
#  ##     #  ## #### ## ## ### ##     ##   ######## # # #  ######## ##### ## ######       ### ########  ## # # ##    ## ##   ###      ## ##### ##### ## ## ### ##   #
######### ## #  ###     ##  #  ##### #### ## ## ###   # # ## # # #  # ##  ##   ##   ##### # # ## ##    ### #      ## #   ###     ### ##### # # #   ####  #  ####  ###
# # #  ## #  ## # #### #### # ## ### # ## ## ## # ### #   ##   # ##   ## ##  #### # #  ## #       # ##  #    ###########  #  # #   # ## ##   # # #####  ## ## ## ## #
#   ##    ## ##   ##    ##  # #    #   ##     # # ### ## #### ## ####    ## ##  ###### #  # ##### ###  ## ####  # # ## ## # ##### ####  #### #    ##   ###  # #   # #
# #    ##     # ##### ###  ## ####   ########     # # #       ## # #  #####  ##  # #   ##   ### ####  ##   # ##     ## ## # # # #  ##  ## ## # ##### ###   ## # ### #
#### ##### ##    # #    ## ## #  # #####  # #####   # # #######  # # ## ##  ### ## ###  ## ## #  ##  ##### #  ## ####  #        ####  ##  #      ##    ## ###    ## #
###  #   ##### #   ## ###  ## ##     # ##      #### # # ###   ##     #   ## #   #  # ## ##      ##  ###### # ##     ## # ######  # # #### ### ####### ### #   ####  #
#   #### ## ###### ##  ## ##   #### ## ### # #              ########   ###    ### ## #  ## # ####  ##### # #  # #####        ## ## # # #  # #     ##    # # ### ## ##
#####                 ##     ###    #   #### ######## #####  ## #  ## ##### ###    # ##    ### #  ## ##      ## ## ##### ########  # # ## # # ####### ###     # #   #
###   # # ## # ## ###  ### ######## # ### #### ## # #    #####  ##  # ## #    ## # #    #####  ## ##  ## ######  #  # ##  ##  ##  ##      # # # # ##    ## ####   ###
# ##################  ## #  #  ## # #   #  ##     # ## ### # ## ###   #    ####### #### # # # ##     ###   ## ## ##    ##  ##  ##  ## ##### # #      ####   ### ### #
#      # # ## # ## # ##  ## # ##      # # ##  # #   #        ##  ### ## ###### ##  #        #  ## ####   ###  #  ## ##  ##    ##  ##    ##      # #####   ###       #
#### #                ## #     ########   ## ######   ##########  #  ##  ##    ### ###### ### ##     ### # ## # ###  ## #  # ### ##  ####### ######     # # ## # ## #
# #### # # ### ## # #    # ##### ## ##  ######## ## #  #   ##  ## ## ## ##  ####   # # ## # # #### ### #   ## # #   ###### ####   ##  # # #  ### #  #######    ###  #
# # ################## # # #  ## #   ##  # ## #  ##### # ###  ##   #  # ###   #### # # ## #    # #   # ## ##      #### ##   # ## ##  ##   ##     ##    #  ## ########
# #  ## ##       # # ###     ### ### ### # ## ## # #     # ## #### ##    ## ### #      ## # ####   ###     ### ##    # ## ### #   ##  # ###  ### ### ### ##    # # ##
# # ##  ########   # ##### ####      #     ##      #### ## ## # #   #### ## #   ##### ##       # ###   ##### #### #### #  ##    #####     ##  ## # #   #  ### ##    #
# # ###  ###   ### # #        ###### #####  #### #  ##   #  # # ###  ##       ####     ## ###### # ### ## #  ###     # ##    ###### # ###### #####   ### ###     ####
# # # ## # ###       ##### ######     ## ##  ######  ### # ## #  ## ### ######## #### ##   ##    #  ##  # # ## # # ### #  #####   # # # # #   # #  #     ##  ### # ##
# # # #  # ##  # # #   ##   ##    ## ##   # ## ## ## ###   ## ## #  ##     # ##    ## ### ##  #### ##  ## # ## # ### # # ##   ###         # ### # ##### ####  ####  #
#   # ## # ###########  ###  ######   ###   ##  # #  # # ####  # # ### #####  #### #  # #  ## # #   ## ## # #    ##    #  # ### ### ####### ### # # ##### ## ## ## ##
###   ## #  ##         ## ##  # ##  ### ### ## ##   ## #  # ## # # ##    ### ### # # ## ##  # # # #### ## # # ##### #### ##  ## # #    ###  # # #      ## #  ##     #
##### ## # ########### #   # ## ###  #       #  ### #    ## ## # #    # ## # ##  # #  #  ## # # # # #  #  # # # ##   #    # ###     #### ##     # #### #    ##  #####
# ##  ## # ##  ## # ##   # # ##  ### # ## ## # ## # ####  #  # # #### ###    ### #   ## ### #         ## ## # # ## ### ####   ## ##   ## ### ## #  # ###### ###     #
# ### ##   ## ##     ##### # #  ## # ######  # ##    ##  ## ## #  ##    ## #   # ### #  ##    #### # ### ## # # #       ##  ###   ######  #   # ##    # # #  #  ### #
# # #  # #    ###### #  #  # ##       # ####    ####  # ### #  # ##  ######### # ##    ### #### ######    # # # # #### ##  ###  ###  ##  ## ###### #### # # ## ######
#     #######  ##    ## ## # ####### ## # #####  ####   ##  # ## ### ## # ##      ## ####         # #  ####   #    ####### # ## # ##  ##      ###   # # # # ##     ##
## ##   # # ##  ####       # # #     ##   # #   ## #### ###       ##  #    # # # ##  ###  ######### # ####### # ####  # #     #   ## ##  ###### ### # #        # #  #
####  #   #  ## #  #######     #####  ### # # #     ##  # # ######### ### ######  ## # ##        ## #     ##      ## ## # ##### ###  ## ### ##  ##  # # ######## # ##
# #  ## #   ##  # ##    #### #  # ## ## # # ###### ##  ## #  ##  ##   # # # # #  ### # ## ########    ######## ####               ##         ## ### # # ## #######  #
# # ####### ###   ##### # ##### # ## #  #   ##      ##      ### #### ## # # #   ## #       ##      # ## # ##   # ### ###### # # #### ### ###### # # #          #### #
# ### ## #   ### ## #   # # ##    #  ## ###  ###### ### # #     ##      # # ###  # ## ######## ########    ###           ######      #####    # # #   # # ### ## ####
#      # ### # # #  ###      #### # ##    ## # #     ###### #####  ## # # # ##  ##  #   ## #   ## ##  ## ###   ##### # #  ######## ###   ## ###   # ############ # ##
###### #  #      # ## ######         ### ##  # # ###  ## #      ####### # #  ##  ##   ###    #     ## #    ### ##  ###### # # #######  ###    ## ## ## # #   ##     #
## # # ## # # ##      ## ####### ### # #  ## # ######  # ## ######  ##      ##  ##### # ## ### ## ### # ####    ##  # ##          # # ## ## # #   #        ###### ###
#           #  ##### ##    # ##### #     ##     ##    ##      #  ## #######  ##  ##          ######   #    ####  # ##  ### # # #### # ## ## #### ## ######### # # # #
# ## # ## #### ###   ##### # # ### ##### ######  ####  ## ## ## ##   # ##   ####  ### ######  ## ####   ####  ##    ##   ####### ## # #  ##  ##   # ###     # # # # #
###  #  ######## ### # #   # # # #  ##   # # #  ##    #####   #  ###    ### # #  ###    #######   # # #   ## #### ###  #  # # #     # ##  ##  ## ##   ## #### # #   #
###### #### # #        ### # #   ##  ### # # # ######   ##### ##   ## ### #   # ###  ####     ## ##   ## ##   ##  # # ### # # # ##### ## ##  ##     #     ##      # #
#   #####       # ## #       ### ###   # # # # ## # # ###  ##    ###    # ### # # ##   #  ######  # ####### ##### #     #         ##     ## ### ##### # #    # ######
###   ##  # ############### #### # ### # # # #    #     # ###### # ## # # # # #   #  ### ### # ## # # # # #  # #    # ############### ####  ##     ######### #  #####
#   ##############          ##   # ##      # # ## #### ## ## # # #  ###   # # ## ## ###    # #      #     ## # ## ###   ###  # # ##      ## #  # #   ### ##### ## # #
###  # ###      #  ## # # #    #    ###### # ###        #  # #   # ###  # # # ##        #### ### #### ######    # # #####   ##    ## #####    #### #  #    ######   #
#   ## # ###### # ####### ## ### ##  ###   #  #### ### ## ## ### # ##  #### #  ## ####### ## ##         ## ## ###       ###  ## ###  # # # #### ####### #### ##   ###
###      ### ## #### # #  #   ######     #   ##  ### # ##  # # #   ###   ##   ###  ##  ## #  ## #########  ## # # ##### ##  ### ##  ##        #  ## #         ## ####
#   # ##        ##       ###### # ### # ####  ## ##    ###     ### # # ##### ## # ### ##  ## ##  ## ##    ##  # # ### ##### # #  ##  # ###### # ##    #######       #
## ############ ###### #  ##      # ### #  ##  # ## ##  #### #  ## # #   ##  ## # # # ### #  ## ##   ## #####   # # #  ####     ##  ## ## # ### ## #### ##  # #######
#### # #  #   # # ## ####  #### #    #### ##  ## ##### ## ##### #      #### ### #   #  #  ## #     #### # ##  #   # ##  ##  # #####     # # ##   #  # # ## ##### ## #
# #    ## ###   # #  ## ############ # #   ## #   ## # #   ## # #### #    # ##  # ### ## ##    ## ##  # # ## ### ##  ## ## ####  ## ###        ### ##    # # # #  # #
# ## #     ####     ##   # #  ##       ### ## ## ##  # ###       ##  ### ## ### #  #      ### #######   #  #   #### ##  #  # ###  #  ####### #        ##         ## #
#  # ### ### #### #  # #     ####### #   # #      ## # # ###### ####  ####  # #   ## ######## ## # ## ### ## ###  #  ##   ## # ##   ## ## ######### # ## # # # #  # #
## ### # ##  # #####   #### ##  # #  ###     ## #  #   # ## #    # ##  ##  ## ## ##    # #    ##       ##      ##   #### ##     # #  #      # #   # #  # # ##### ## #
#   #     ## # # # #######   ##   # ##   # #  #### # ### #  #### # ###  ## ## ##  ## ### ####  ## #### #  ####### ######  ## #### #### # ##   # ### ######### ##### #
###   # #            ### ## ##### #  ########### # #  ## # ## #     ### ## ## ## ###   # #  # ##    #####     # # ## ##  ### #     # # ###  #     #  ###  #     ##  #
########## ######## ##      ##  # ####         #     ##    #  ### ### # #  #       # ### # ## ## #### ##  ##### #  # ###   # # ###       ##### ####### ## # ####### #
#          ##          ## #  ## #  #### # ## #   # #  #### ## #         ## # #######  ##   ## ##       ##  ## # ## # # ## ##   # ##### #    ##   # ##     # # # ##  #
### # #### ## ## ###########  # # ##  # ###  # # ####  # # ## ## # # ##          # ##  # ###     # #####  ### # #    # #     #    # ##### # ## ### ### #### # # ## ##
# ###### ##########   # ## ##     ## ## ########### ##         ########### ####### ## ## # ## # ##  ## ##   # # ## ###   ########   # ########## #      ### # #     #
# ## ##   ## # ## ### # #  ######  #  ### ###   ##   ### ## ## ## ##  ###      ##     ## # #  #  # ##  ## ### # ##     #        # #    # # # ###   ###### #     ## ##
# #  #### ## #            ## ##### ## ##  # ### ####  ########     ## # ## ###### #####  # ## ######  ##   #    ## ### ###############     # # # #   ## # # ###  ####
# # ##    ## ##### # #### ##       #   ##        ##  ## ## # #####          #   # # ##  ##      # #  ### ### ####   ##    ##### ## ######### # # #####      # ##### #
#    #### #  #  #######   ## # ### ## ########## #  ##       ##    #### ###   ###    ## ## ###### ## ##    # ## # #########           ## # #   #  ## ### ####    #  #
####   ## ## # ## ##  ###  #####        ### ##   # #########  ########  #   #   # #####  #  ##  # ##    ## # ##       ##    ###########  # # ### ##   ## # ## #### ##
## # ###   # #  #  ##  #  ### ## # ## ### # #  #   # ## ###  ##   ## ###### #####  ## # ## ####    # #######    # # ###  ##  ##  # #  ##          # #### #  #  ##   #
#    ##  #     ## #### ## # # #### ## # # # ## ###        ##  ## ##   ## #   ## # ##     # # #  ####   ## #  # ## #     ####    ## # ##  ##########      ## # ### ###
####  ######## ## # #  #    #   #  #  # #   ###### ######  ## ## ### ##  ## ### #  ## ##       ##    ####   ####### ## ### # ## #  #  ##          # #######     #   #
## ## # ##     #  # ## #### # #   ### # ###   ## #### # ## #  #       ##      # # ##   ## ####  ## ### #  # ### ######## # ####### # ##  ###### ###     ##  ###   ###
#        ##### ## # #   # # ##### #     # # ###   #   # #  ## ####### ##### ###   ## ###    ### ## ###   ##  #    ######   ##  # #      ### ####### #######   # ### #
# ## # #  ## # #    ### #    # ########     # ### ### # # ### # ## ##  ## # ##  ###    #### # ###      ##### # #### ## ## #### #   # ##   #     # # # #     # ###   #
######### #    ####   # ### ## # # #    ### # ##          # # #     # ##       ###  ####  # #  ## ####    ## #  # #  # ## # ## ## ###### ## ##### # #   ## ##   ## ##
### # #     ##  ##### #  ## ##     # #####     ###### # #     # ###   ##### #### ## #  # #####  #   ### ###### ##   ## #  # #  ## #### ####  ###  #   ####  #####   #
# # # ######### # # # # ##   ##### ### # ##### ##     # ##### ####### #  ##  ##   #   ##   # # ## ### #### ##  #  #### # ## # ##   # #  # # ## ##   #    ###### # ###
# #   #  ###  #          # # # #          ####  ####### #               ##  ##### # #### ###   #    #  # #  ##   ##  # #  # #  ## ##   ## # #  ## ######### # # # # #
# ###   ## ## ##### #### ###   ####### ## #  ## #  ######### ###### ### ###  ## # # ##     ###   #### ## # ### ###  ## # ## # ##   # #### #   ##     ###  # # #     #
#   ###             #     ## #   # # #### ##    # ##   ## #  ##     #     # ##    #    # # # ###  #   #  # #   # # ##    ##      ###  # # # ###### ### # ## # # #####
# ############ # # ##### #######   # ## # ##### #    #      ##  ## ### ## # ##### # #### # #  ## ## ### ## # ###    # ###### ##### # ## # #   #          ## # # ##  #
# # # # ##     # ###       ## #### # ##         # ## ## ## #### ######### #  ## # # ## ###### ##         # # # # #### #  ##     ##   #      #   ####### ##       # ##
#       #### # # ######## ##         ### ###### ############# ###   #       ##          # ##  ## ######### # # #   ## # ##  #####  ### ## # # #       #### ## # ##  #
####### #  ### # #         ######## ## ###       ## # ### #    #### ####### ## ##### ####    ###  #   # ##       #  # #  ##     ##   # ######## # # #  # # #### ## ##
#       # ########## # # #  ## # ## #  ##  # ## ##  # # #   ##      ## # ##  #   ###### #### # # ## ### ## ########## # ### #####  ### # #    ### # ##        #    ##
#######    # ###     # #### #  #      #########  ## #   ########### #  # ###   ### ## #  # # #        # #    ## # # # # # #       ###      ####   #  ## ## # #####  #
#   #### # # # #### ##### # ## ######  ## # # ## #  # #####    # #  ##       ####  #  # ## # ## #######   ##            # # #####   # ## #    ### ##########    ## ##
###      #      ##### ##       ## # # ##       # ##    ## #### # ## ######## #    ## ## ## # ##       # ##### ###########    # ####   #######   #### ##  ### ########
#   ## ### ## ### ##  #  #### ##         # ###    ####  # ##                   # ##   # ## # ## ##### # # # #### #### # # ##      ###   # ### #####   ##   #### # # #
###  ####  #  # # ### ## #       ## #### ####### ##    ##  ################## ###### ##  #          #        ##            ## ########### # ### # # #### ###        #
#   ##  ## ##     # # #### ## # ##  ######## #    #### ### # ### ##  ##    #    ## #    ## ### ### ### ## ##### ### # # ####  ##### ### #    ## #    # # ##### ## # #
####### #  ### ## # # # ##### # #  ##      #   ##          # #      ###### ## ###    ##      # ##### #########   ######   ###             # ### # #### # # ##  ## # #
#### ## ##   #### # # #   ##  # ## ### # #   #### ######## # ######  ##         ## # ## ### ####  #  ###       #    ##  #   ### # # #### #### #   #### #    ##  #####
#    #     #####    # ###  #### #  #   #### ### #### ### # # # # #  ######### ###  ########## ## ## ## ### # ######### ### #### # #    ### ##   #      # # ####  # ##
#### #######   ####   # # ## #########  # # #    #             #   ## # #     # ##  #                   #  # ###     ####   # ### # # ##   ## ### # ##   ### #  ##  #
# #  ##    ### ###  #         ## ##    ##   #### ########### # ### ## # ##### # ## ## ############## #### #### ## ##### ###     ########## ## #######  ##### ##    ##
# # ##### ## # #   ### # ####  #  ###########        ###  #### # # #  # ##    #       #     ##   #####  # # #           # #############          # ####### # #  #####
#    # #  ## # # ### ###### ## # ## # ##   ######### # ## # #  # # ## #  #### # ##### # ###  ## ##  ## ## # # ###########  ## # # # # ### ######    # ##   # ##    ##
### ## ##        ###    # #           #### # ##        #  # ## # # #  # ## ## #    ####  ###### ## ##   # #     # # ## ### #    #     ##  #    # ##      #      ##  #
##     ######## ##   ## #   # # ##### # #     ######## ## #        ##         # #### ## ## ## # ##  ## ##   #####    #  ## # #### #######   # ## ## #################
#  ### # # ##   #  ###    # #######     #### ## ## ##       # ### ##  ####### #  # # ## ## #  # ## ##     #   #   #### ### #      # ##    ###### ##                 #
# ##          # # ##   ## #### ## # ### ##            ### # ### # ## ##       ##      #  # # ## #   # ######### ###### ##    ## ### ## ## ## # ###  # ## #### ## ####
###### #### ######### #######     ###    # # ######## ### # #     ########### ## ###### ## # ##   ### # #  ###       # ## ####### #     #       ##### ####  # ##   ##
#  ########### # # #  ## ## #####   #### ######## # ### ####### #  ## ## #        #  #   #   ## ###       ## # ####### #       ## # ## ## ####### ##       ####  #  #
## #  #    ##    # ####   # ## ## #####  ## ##      ### ###  ##### #  ## ###### ### ## ### ###  #   # # #          # # # ########    #  #      ## ########   ### ## #
#  ## ####  ####   # #  ### #      ## ##     #### #     # ## # # # ## ## # # #    #      # # # ## ####### ### # ##   # # # ####   # ### # ## #  #        # #   ###  #
##    # ## ## ####   ## # # ##### ##   #####  ### ## ##            #   # # # ## ### ### ##              #######  ###            #########  ####   # # ## ### ########
#  ##    #     # ###        # #    ## ## # ## # ######### # # ## #   #               ####  ## ## # #######    ##   ## ## ##########  #  # ### #################  #  #
# ###### ##### # ##  ###### # ## #  # #          # ## ##  ######### ############ ##### ## ########       ## #### ####### #        ##   #### #  ##### #  ## ## ## # ##
#  ##    # # # # #  ##### # # #  ##     # ##### ## #   ######## # ####   # ####        ##        ## # ##     # #### ###    # ####    #   ##   ##  #  # ##           #
####  ##           ##         ###### ######          #  ### # # # #    #        # # ##    # ## # ####### # #          # # ################# #### ## ##    #### # # ##
## ######### # # ######## ###   # ###### ### # ####### ## #         ## ## # ## ## # ## # #######   # # ##### ##### # ## #  ###   #### ##    # #        ######### ####
#            # # #        ##  #              # ######       ## # ########## ## ####### # #     ###        ##     # #  # ##     #         ##     ## #######     #  # #
## ###### ## # # ## ### ###  ### # # # # ### # #      # # #### ####  ##     ##     # # #   ############# #### #### # ####  ## ############## # ##        # ######   #
############ ### ####   ###### ####### ####### # # ## # #### #### ## ######### ###   # # #       ##### #    #    ######### #### #          # ###  # # ##      # #####
#        # ###   # #  ### #    ## #    ##   #### #########   ##    # #           ## #### ## # ##       ############ # #  #        ## ## ######### # # ## # ####  ####
########   ##### #   ##   ####      #######  ### #       ###  ####   ### ### # #  # # ## ## #### ## ##  # ## ###  #     ###### # ##   #     #   # # ######      ##  #
## #     #   # #### ##  # # ## ## ###   ####     ####### ####      #   ##### ### ##   ####   ##   # ###          ## ## ## ################### #####     ## ####### ##
#    ## ## #        ##### # #   ####### #    ### #            ## # ## ###      # ## #    ## ##### #  ## # ######     ###          # ## ######    #### #  #          #
## # #  #  ## # ## ##         #  ##       # ##   ## # # # # # #  # #      # # ## ## # # ##     ## # ##  #      ## ##     # ## # #             ##    # ## # ## ## # ##
################################################################################################################################################################## ##
