# #############################################################################################################
# #          # #    # # # ##  ##   ## ####  # #        ## ## #      # # #   # # #       # ## ## ## ## ## #  # #
#   ## # # #   ####   # # ## ##### ##  ##  ## ## #### ##       ## # # # # ### # # ### #                    ## #
############ #      #         ##   ## #### #  #     ###  # ########## #   #        #### # # # ## ### # # #### #
#    ## # ## ## ### # # # ## #####  # ## #   ## # ####  ##     # # #    #   ## ##### #### # #  #   ### #####  #
####         #####  # #####   # ###    # # #### #####  ### #####     ## ###########     ##### ####  ## ##  # ##
#    # # ##### # ## ###  ## #     #### # # ## #  ## ## # #       ## ##     ## #     #####  ##    ####     ##  #
#############         ##  ##### #####    #  #   ##       ## ## #  ###### #      ###     ## ######## #######  ##
# #   ##      ########### #      ## #### # ## #### ########### ##     ####### #   # ## ##               #### ##
# # #  ########    #  #   ##### ### # #        # #           #### # ### # ###### ## ####  # # #### ###### #   #
# ### ## # # ##### ## ###   #           ######     # ### ###    # #          # ###### #  ############ # # # ###
#  #  ##       #   #      #   ## ## # #      ### ############ # # # ########    # ##    ##  ###  ###          #
## ## ########   #   ## # #####  #  ### ## # ######     ##  # #####        # ####  ## ###  ## ##     # # ## ###
#  #   # # ######## #######     ### #    # #        # #  # ######   # ######      ##      ##  ## ### # #  #   #
## ###   # # # ###   ##     # #  #### # #### # ## ######   # #  ## ###### #### # ##  # ##  ##      # #### ## ##
#      #           # ## # # # # ##    #    # #  ### ## # #     ######       ####### ######### ######  ##  #####
##### ### ### # ## ######## # ####### ## ### ##  #     #### # ## ## ## ###### # ##   ##   ##     ####  ##     #
# #####   #   #  # ## ## #  #####     ##   #  # ## ## ########## #  ##             ###  #### ###    ##  # # ###
#    #  # ## ### # ## #    ##     # # ### ## ##     ###  # # # # # ##  # # # #####     ##  #  ########### #   #
# ##   ##### ##  # #    ####  # # ### # #  ###  # #   ## #   # #      ## # # ######## #### ##   # # # ### ### #
###  ####     ####### # #    ## # #     ##   ## # #####    #     # # ### # #      ##### #     #         #  ## #
#   ##    # # ### ##  # ## # #  ### # #  ## ### #  ###  ## ## ######   ###### # ### ##  ## # ## ##### #### ## #
# #  ## # # # # # ### #  ######  ## # # ### ##  ##     ##   #      # #   ## # #        ### ####    ##    ######
# ## ## ##### #       ######  # #########    ## ### ###### ## ############  #### ## # ##      # ##  # # ####  #
#### ##### ###### ## ### # ##      # # ## # ##   ##      ##########   ## ##  # #  # #    # ####  # ## #### # ##
## #  ##     # #  ## #     ##### #     ## # ### ### ####### ##      ###  ## ## #### # ## #  #########         #
#    #######     #########       ########## # #   #            ######## ##      # ########### ## ## ### #######
## # ##    ##### ##   #    ### #       ##     # # ### ###### #     ## #    # ##     ##     #          #       #
#  # #####        # #   # #### # ## ## ### # ## #   #      ### ## ##  # ######## ####  # #   # ## ## ### #### #
# #### # ###### # # ### #### # # ##### #   #  # ## #### ##   #  #  ##          #  #   ## ## ##  #  ### ########
# # #  #        # # #   #  #   #     ######## # #  # ##  ## ## ###    ## ## #####   #  ######## # #### ##     #
# # ## # ### ## # ##### ##   # # ### ###      ####    ##### ## ##  # ########## ######     # ######     # # # #
# #      #   #  # ##     ## ## #  #### ######  # ## #   # #  ###  ##  # ## ##     ## ####### # #  ## #### #####
#### ## ### ## ##  #######  ## ##        ##   ## ## ##### ###### ####         # #     ##     #   ##   ##      #
#    ####   ## ### ###   ## ##  ## # # ###### ##       ##  # # #### # # ########### #    ##### ###  #### ######
#### #    ###### ### # ###   # ### # #    ######## # #    ##    ##    #      # # ##### # # #     # ##      # ##
#    # # ####    ##        # # ##  ### #### ##     # ## #    ####### ## ### ## #     #####   ## ## #  # ####  #
######## #    ##    # # # ######## ##    ##  # ## ## #### ##   # #####   ##      ######### #  ####   ##### ## #
#        # ## ## ## # ###   ##     #### ####    ###     # ## #      ## #  # ## # ##### # # #####   ### # # ## #
### ## ############ ##### # ## ###    #   ## # ##### ## # #  ### ##### # ##### ###           # # #####   # ## #
#    ###  # ### #    ##   # ## ##### #### ## ###      # #### ##    ##  # # ##   #  # # ## ####    ## ## ##  # #
# #######         # #### ## ##    ## #  # ##  ## # # ##   ##  # ###### #    # #   #### ##   ## ####        ## #
# #  # ########## ###  #### #  # ##    ## ###  ### # ## ###  ##   # ## ## # # ###    # ## #         ## ###    #
#### # # ###          ##    # ##  ## #### # # ##   # ## #### ## #    ######## ##  ## #  ### ## ####  #   # ####
## #         # # # ####### ##### ##     ###   #### #  #   ## ## # ##  #     #  ##  ####  ## ##    # ## # #    #
#    ## #### # # #    ##   #     ## # #  #### #    # ######  ## #####   ##########    ##### ## # ##### # # ####
# ##  # #    # # # # ##  # # ## ##  ####   ## ### ##      ####      # #          ## #   ##  ## # # # #####    #
# ## ## ### ## ### #  ## # ###   ##  ##  #  ###    ## # #    ## # # # # ############# #  ##  # #         ## # #
#  #### #   ##  ## ##  # # #   # #  ##  ## ##   ##  # # # ## ## # ### #       ##    # ##### ## # #### ##  # # #
##  ##  # #  ## #  #  #### ## ## ## #####  ### #### ### #  #  # ####  # # # #    ## #   ##   # #    ####### ###
###  ## # ## ## # ## ## ##### ####   ##   ##     ## ###### # ##    # ## # #### #  ### #  ## ##### #  # ## #####
#   ##  ###  ## # #  ##        ##  #  ###  ## # ##      ## #### ## #### #  ##### ###  # ##      # ##   ##  ## #
# #  ## ##  ### #### ### ## # #######  ### ## #  ## # ###     #  #    ####  # #### ## # #  # # ## #  #    ### #
### ##   #####   ##  #   #  #       ##  ## ## ## ## ###   ## ## ### #   ###        ## # ## # # ## ## # ####   #
#    # #####   #  ## # # ## ## ## ##### ## ## ####    ## ##   # ##  # ###   #### #  # ######## #  ## #      # #
# # ####     ### ##  # ###  #  ##     # #   ### #  # ##   ### # ### #   ### #########  ## # #####  # # # # ## #
# # #  ##### ##   ## ######### ## # # # ## ##     ## ## #   # #   # ## ###      ### ##       ###  ## ### #  # #
# ### ##     #  # ####          # ########  #####  # ## # # # ## ## #  ##  ## #  #   #######   ##  # ### # ## #
####     # # ## #   ## # ## ## ##    ##    ##     ## ## ### #  #######  ##  # ##   #      ## # ## ## #   #  ###
## ## # #### ## ## ##  # #  ## #####  ## ####### #####   #####   # # # #### # #  ##########  # ##  # # ### ####
#     ###    ## ## ## ##### #      ##### #       ## #  #  ## #####   # #  # # ##          #### ##### # ##     #
# # ####  ##  ###  #  #   # ## # # ##    # ### #    # ###     # ####     ## #### ## # # #  ###   ######### # ##
# ###    ####   ## # ####   ## # # #### #####  # ## # ##  # ### #  ## # #######  ########### ###      ##   #  #
#   ## ###    #  # #####  # ## # #  ##  ##    ## ######  ##     # ##  # # ### ##           # ##########  ### ##
# # ## ##  ## ## ######  ## ## ### ####  ## # #    ##### #  ###    ## #       ## # ### # #        # #######   #
### ##  ## #   ####  #  #####    # ##   ##### ## #  #  # ##   ## #### ## # ####  #   # ### # # ##     # # ### #
#   ##########    ##   ##     ## #  ## ### #  ## ##   ##### #### #    ## #   ## ## # ####### #  ## ##     #####
###   ### # ## ####  #  # # #### # ##  #     ### #  #     #    # ### ### ######  # #       ######   # # #     #
#   ###          ### ## # #    # #  ## ### # ##  ## ## # ## #### #   ##  #### ######## # #      ## ## # ## ####
###  ## # ## ## ##   ## # # # #### #####   # ### ## ## ###    ## ###  ##            ## # # # ## ##  # # ##    #
#   ######## #   ## ### # # #  #####     # #  ## #  ##   ## #  ###   ##  # # ## # #  ####### ##  # #### ## ####
### ## # ##  ## ##  #   # # ##   ##  ## ## # ######### ###### ###### #  ## # ## ### ####  ##  ## # # #  ##    #
#   ##      ###  ###### # ###  #  ##  # #  # #             ##  # ##  ## ## ######    # ## ## ### #   # ##### ##
# # ## ## # #   ##      # ##  ###  ## ### #### # ## ## ### ###   ## ##  ##      ## #    #  #   # ## ## # #    #
# #  # #  # ### ## # # ## ## ## ## ## ### ##   # ## #   ##   # #  #  ## ## ####  #### #   ## ### ##  ### ## # #
# # #### ## ##   ### #  ###     ## #    #  # # # ## ## ### # # #######   #    ####  # # #### ########### #  # #
# #    ###  ## #  #####  ## # #### ### ### # # # #   # # #####   ##    # # ########   #  # #   ###  ##     ## #
# # ####   ### ## #     ##  # ##    ##  ############ #      ## # ## # ## #        ### ## # ##### # #### ## ## #
# # #    # ##  ## ## # #### # #  # ##  ## # # # ##   # ## ###  #  # # #### ## #####   ##      ##     #####  # #
##### # ##  ##  #  # #   ## #### #  ## #           ### #### #### ## #    # ##     # # ## # ##    ###   # #### #
#     #  ##  ## # ##### ##   ##  # ##  # ######## ##         #####  ## ####### # ## ###  # ## # ######     ####
## ## ##  # ##  #    ###### #### ##### # #         ## # # ##     # ##   # #    ######   ##  ###     ######    #
####   # ##  ## # ## #       ##    # # # ### ## # ##  # #  ## # ## ### ##   ##      ###  # ###  # #      # ## #
# #  # #  ## #  # ##### # # ##  # ## ########## # ## ## # ##########   ## ###  ## ####  ## ##  #### # ####  ###
#   ## # ###### #     #####  ## ###   # #       #  # ## #   ## # #####  #   ##  #    ## ##  ## #  # #    ## ###
# #  # #    ##  # #####     ##  #####     # ## ## ## ## # #      # #### #####  ## ## ##  # ##    ## # ## ##   #
# ## # ## #  # ##    ### # ##  ##     ### # #  #  ##  ### ## # ###   ##     ##  # ##### ####  # ##### ##  #####
# #  # #  # ##  ## #   # #  ## #  # #  ## # ## ##  ##  ##  # #     #  ## # ##  ##   ##     ## #     #  ##     #
############################################################################################################# #
