# ##############################################################################################################################
# # ## ## ##    #   ##     ##        #   ## ##  # ##  ## #  ##    # ## ##  # # #      ## #  ##   # ##  # #  # # # #    # # # # #
# #  # #  ##### ## ###### ####### ## ## ###    ## ### #    ### ####  #  ## # # ## ### ## # #####   ## ##   ##     #### # #     #
#   ## ## #     #  ##       ## ## #       #### ##  ## #### ##   # ## ## ##     ####   #     ##   #### #### ### ####  # # ### # #
### ##    ##### ##  ###### ##  ######## #### # ## ##  ###     #   ## ##  # ### #  ### # ########  ##   ##   #     ##      ## ###
#    ####        ##  ## #   ##   ## #   ##      # ## ## ####### ###   ## #   ### ##   # # ## ##  ### ###  #   ########### #   ##
## #   ######## ### ### ## ##  ###  ###  ##### ## #     # #  #  # ###    # ##### ####   # ##  ## # #   ######     ##  # #   #  #
##### ##        ##   #     ###  ### #   ## ##  ## ### #   ## # ## # ####   # # #    ###    ## #  # # #   ## # # #####     ### ##
# # #  ##### ## #### #####   ## # # ### ## #  ### # #### ### #  # # ##### ## # ## ###### ###    ## # #####  # ###  ###### ######
#     ##     #    #  # #   #             # ## #      ##  ##  ##   # #  ## #    ##      # # ## ###  #  ## ##    ## ##      # ## #
### ####### ##### ## # ###### ## # # ### # #  ##### ####  ##  # # # # ##    ##########   # ##   ## # ##   ### ###  ###### # ## #
# #  ## ########               ### ####      ##     # ## ### ####      # ####   ### #### #  ## ### #  ## ##   # # ####    #    #
#   ###    # # # # # ### ###########    # ##  ##### # #      # #  # ##   ## # ### # # #  # ##  # # # ### #### #   ## #### # ####
### # ####     #############     #### # #  ##  ## # # ###### # ####  # ####   # #   # ## #  # ##          ##  # #### # #  #   ##
### #  #######   ##### ### ### ### ###########         # # #    ##  ##### ###   ### #  # # ## #  ### ### ####    ##    ##   #  #
#   ## # ## #  ### #   # # ##  # # # # # ############# #   ####  # ###  # ##  ###   ##     ## ##   #  ##### ## ###  ####  ######
## ###   ## ##     # #      ## # # #       ##          ## ## ### # # ## # ###  ### ##  ### #   # ###### # # #  # ## #    ## ## #
#    # #     #### ####### #### #     ### #  ######## #    ##   # #    # #   ## # #  ####   # ### # ## # #     ##    #### ##  # #
### #### ###        ##     # # ########### ##  ## #######  ### # # ####   #### # # ## #### # # # # ##   # ###  ## #####  #  ## #
#      ######## # #    # #       # ###  #   ## ##  ## # # ####   # ## ## ## #  # #  # # #  #   # # ### #### ## ##  ## ## # ##  #
### ######   ####### # ### # # #   # ## ## ### #  ##    #  # ###      ## ## # ## ##   # ## # ### # # #  ##  ## ### ##  #      ##
#   # ##   #  ## # #####   #######         # # ## #####   ##   #### ###  ##    #  ## ## ##   ##  # #   #### ##  #   ## # #######
###    ### ##    # ############ #  # # ###        #  #### ### ##  # # # ### #### ### ##  ## ####   # ####    ## ## ##          #
# ## ### #######   # #       #  ########   # #### # ## #  #    ## #      #  # ## ##   ##    # #### # #  ### ##  ##  ### ### # ##
# ##  ##  ## # ###   # # ### # #### # ########       # ## ### ### # ###### ## ##  ###  # # ## # ##     ## # ## ##  ##     ######
# ## ##  ##      ### ######    ## #    # ## ###### #        # #            ## ## ## ##   # ## # #  ###### # ##  ## #### ###  # #
# ##  # ###### #     ## #   ##    ####    # #  ############ # ### ## ########    ## #  #####      ## ##   # ## ##   ##    ## # #
#  ## #  ## #  ## ##  # ###  ## #    ## #   ##   ##         # ##   ###### # ### ##  ##   ##  # ##     ###   ## #  ###### ##    #
##  # # ##  ####   ##   # ########## #### #  ###  #########      # ##   #    ##  ## #  #########  ##### ### #  ##  # ##  #  ## #
### # #  ##  ######### ##  # # #      ######   # ## #       #### #### # # ####  ##    ## ## # #  ####    ## ## ## ##  ##   #####
#       #### # # ##  # ### # # ##### ## ######    # ### # # #     # ### #    ## #####  #  # # ## ## ## ###        ## ##  ### ###
###### ##  #      ##     # #   ##     # # # ##### # ##  # # ##### #  ## # # ##    ### ## ##   ## ##      ###### ####  ##       #
# # #   ## ##### ##### #   ### #### #     #            ## # #       ##  # ###### ##   #   ### ##  # ###### #     ##  ##  ### # #
#   # #### ## ## ## #### #     # ########   ###### ## ########### #  ##    # # # #### # #     ### #    # # #### #### ## ########
### # ## # ## #  ##   ##### ##   # # ########      ## #  ##       ###### ### #    ##  ### #####   # ####    ##  # #  ##        #
# #    # # ## ## ####   # ##### ##         #############  ## ## #  #####  ## # ###### ##   #  ###   ## #### ### # # ### ###### #
#   ##   # #  #     ### #  ##   ### ###### # ### ## ## ##  #######   ##  ### # #  ##   ## ## ##   ###   ##   #        #      # #
### #  #   ## #### ## # ##  ### # # #        # # #      ## ## ## ## #### # #     #### ##  ##  ### # ## ##### # # ###### ########
#   ## # #    ##   ## # ### #     #### ### #       # ##              ##  # # # #  # #  ##  # ##     ##   ##  # ###   ## # # # ##
# #  ######## #### #      # ##### ###  ####### # # # #  # # # ######  ##     # #### ##  ## # #### ##### #### #  #### ##        #
############   # # ###### # ##    # #### #   # # # # ## #######    ## ### #######    # ###    ##  # ##  ## # # ## #  ## ### ####
## # # # #   #      ##  # # ##### # # #  ### ##### ####### ###### ##   ##  ###  ## # #   ### ####    ## ## #   ## ## ##  ####  #
#        ###### ## #### # #  ## # #   ## #    # ####   #    #        #  ## # ## #### # ####     ## ###     ###  # #  ## ## ## ##
### #### #  # ###   #   # # ##    ## ##  ### ## # #### ####   #########    #  # # #  # ##   ## ##    ### # ####   ##        #  #
#   ##   ##     ### ###   # #### ##   ## # # #    # #   # ## ##   # # ## ### ## # ## #  # ######### ## # ###  ## ##  ######## ##
## #####  #### ##    #  # # # #   ###        # #### ### # ####  #         ##  # # #  ##      ## ### ## #  ## ### ## ##  # # #  #
#      ##       #### ####   # ### # ## #####    ##  #     # ## ######### #### # # # #### ###### # # ## ## ## # # ## ## ##     ##
# ## #  ####### # ## # ####   ##  # ####     ##  ## ##### # #####        # ## #      ##   # # #     ## #  #  # # ## ## #  ###  #
# ########           # #  ## ####    ###### ####    #         ##  ######    # ###### #  ###   #### ##    ## ## # #   # # ###  ##
### # # #  ## ### ##     ##   ##  #### #  #### #### ##### # ##### #   ## ## # ## # # # ## ## ## ##  ## ####  # # # ###     #####
### #     #####    ## ## ### #### ##   ## ## # ##   ## #### # # #####  # #    #      # ##  # #  ## ##   # # ##       ### ### # #
#   # #####  #  ######## #    ##  #### ##    #  ### #   #     # ##    #######   # ##    ##   ## ##  ## ##    ## #### # # #     #
## #### #### ## #### #     ##  ##  ##   ####   ## # ### #####   #####  ##     # ###### ##  ####  ##  #  ### ###  ##### # # #####
#    #          #      # ##### ###  ### ## ### #    ##  ###### ##     ############## # ###    ## ## ## ## #   ## # ### #     # #
## #   # ## # # ## ########     ### ###  # ##    ## ### #   ##  ##### # # #  # ## #        ##### ##  # ## # ###  #       ##### #
########### #####  #        # #  ## # ## # ######## # # ### #  ## ##      ## # #  ### ####  ###  #  ## ## # # ## # ## ##       #
#           ## ####### # # ## ##      #         ##      # #   ##   ### ##      ## ###### # ## ## ##  # #      ## #  #### #######
## #### ## ##  # #     # # ##  ## ###   ## #### ##### #   ### ## ###   #######  #   ###  #     # ### # # #######   ### ###     #
#########   ##     # # # #  ########## ##### ##  ###  ### # # ##   ##### # #### ### # ## ### ### # # # #  ##     #   # #### ####
# ##  ########## # # ######### # ## ####        ## #####       # ### ##  # #           #  ##  ## # #     ### ### # #          ##
#  ## # # ## ### ### #  # ###     # # ######### ## # #   # ### # ##   ##   ########### ##  ##  # #   ##### # ######### ### ##  #
## #           ########       # #      #      # ## # ### # ### #  # ##### ##  # # #    ### ## ## # ######  # #     #####    ####
#    #########  ## ## ####### # ######   # ##    #    ######     ##  ## # ### #   #### # # ##    #        ##   #####  ### #    #
### ## ##   #  ##  ##     #######      # ####### #### # #  #####  ##          ### ## # # #  ### ## #### #    #     ##  ## # # ##
# ###   ### ##  ## #  # #   ##### ## # ###   ##         # ## # ## ########## ## # #      # ## #  #    # # # ######    ##########
#  ####  #   # ##  # ##### ## # ############    # # ###             ##              ####   ## # ## ############# ## #   ## #   #
##  #### ### # ### ####  # ## # ## #####   ############### # #### #    # ## # # ## ##    #      ## ### ##  # #    ### #      # #
###   #        # #  # ##           # # ### # ### # #       ############# ############# #### ### #       ## # # ###### # ### ####
##### ######## # ##   ######## # #     ##            ## # ##      ## ##### ##  #       #    #   # ##### #  #      # ######### ##
#####  #            #    ############# ## # # #### #  ####### ## ##     ##  ##   ### # ### ####    ## #### # #### # ## ##      #
### ## ##### # # ## ## #      # # ####    ### #    # ### ## ###   ##### #  ##  ###   # ##  #    ##     ##       ###       ######
##           #####  ## ## # #          # ##############         #         ##  #### # # ### # ## ### ####  # # #  #  # ###      #
#  ### # # # ## #  ################# # #### ## #### # # ## ##############    ##    # ###   # #   ## #    #######   ##   # # # ##
# ##   ##### ##   ### ## # # ###  #  # #                ## #              ## ##### # ##  ###### ##    ###### # ## #### #########
# ####### #  #######           ##   ##### # # # # ### #  ######## ## # ## ##  ## ###  ## ## # # ## ## ### #  # #### ###### # # #
### #       ##     ######### #    # # ######### # #   # ##        ## # #   ##    ##  ##  #       ####       ##   #  # # #      #
##    #### ##### #        ## #### # #  # ######## # # # ## ### # ##  # ## ##  # #### ### # ## # ##    # # #    #   ## #   # ## #
#  ## #    # ### #### # #    ##   # ##    # # ### # # #  ###   ##### # ## ## ##    ### # ###  ###### #### # # ## ###    ########
##  #### # #     ##   # # # ##  # #  ## #         ### # ##   # ##    ###  #   ## ##### #   ##   # #   ### # # ##     # ### # ###
#  ###   ###### ##  # # # #  ## # ## ## # #### ## #   # ## ####### #   ## # #  ###       #  ## ##   #   # # # ## ### # # # #   #
## ##  # ##      ## # ##### ##  #### ## ####   ## ### ####### ## # # # ## ### ###### ### ##  ###### # # ##### ########       ###
#  #  ###### # #  ### #      ######  ## #    # ## ##   ##          # # ##  ##### ##   ##  ##    ##  # ####  #   ##   ### # #####
##### #   #### ## #   #### ###### ## ##### # # #  #  ####### ##### ### #  ##        #### ### ####  ##      ## #    ###   #     #
####  ###       # # # ##   #         #     # # # ### ##  # # #       # # ##########    # # # # #  ##  # ######## #  ### ########
#    ###### ## ## ####### ########## ### # # ###  ######     ### ### ##### #        ######   #   ##  ##       #####  #### ### ##
## # #      #  ####       #          #   # # #   ## #    # # #     #### ##   # ## #   ##   #### ####  ## # #### # ##  ##       #
#  # ###### ##    ##### ### ## ## ## ## ## ##### ##   ########## ###       ###### # # ## ###       ##  # #         ##    # ## ##
## # #      ### #####   ##   ######  #   #### #   ## ##            ### # #  # ##  # ###  #   ## ###### ### ####### #  ####  #  #
#### ######   ### # ########### #### # #  ##    #  #### ### # ### ##   # ## #    ##  ## ## ###      ## ##       #####    # ## ##
##   ##     # #   #  #     ## # #    ######## # #####    #### #   ## # #### ### ##  #########  # # ##   ## # ##   ##  ######   #
#  #  ### # ##### ## #####        # ##        # #     ####    ## ##  # #    ###  ##   ### # # ## #  ## ##  # ## ##### ## #### ##
## ####   # ## #     ## #  #### # # ### ##### ### # # ##   # ### ##### #### #   #### ##       ## ######### # ##  ##      # ##  #
######  # # #    # #    ## ##   # #   ####    ##  ###  ########    #####    ### #### #  # # # #      ##    ###  #### # #    # ##
#      ######## #######    ## # # # ####   ## ## ###  ##### #   #### ##### ##    ##  ######## ## ## ##  ##   ## # #### #########
# # # ###  #    ##  # ## # ###### #####  ###   ####  ##       # ##   # # #  ### ##  ##        #   #### ##  ###     ##          #
####### ## ### ####      ### # #  ##    ##   # ## ######### ########       #### ### ## ###### # #    # ###  ## # ###  # # ######
###               ## ### ###     #### # ########            ##       # ## ##      #  ####     # # # ##  ## ##  #   ## # #   ## #
# ## ######## ## ##  #     ## ##   ## # #        # ### # # ##  ## # ####  ### # ######  ##### # # ######## ##### #### ### #    #
# ######       ###  ### ## #  ### ##### #### # #####   ###  ## #  ### ###   ###   ## ## ####  # #  # ### ###        #   ### ####
# # ## ### # #   #####   #### #    # #  ###  #  # ## # #   ########## #   ####  # #  #       ## ##        ### ## ## # # #      #
#          # # ### #   # ## ### ####   ##   #####    #####   ## ###     #    ## #### #### ## ##  ## ### #   # #  ######### # # #
# # ### ## # # # # ## ## #  ##  #  ########  ###### ##     ####     # # ## # ##  ##   ###  # #  ##  ##  # ######   #   ##  # # #
# ###    ### # #       # ##  #####    ##    ##      ###### # #  # # ###  ### ## ##### #   ## ##  ##  ## ####  ### ## ##### # ###
# #   ####   #### ## # #####     #### #  # ##### ##  ###   #   #### ##  #### ## #       ###   # ##  ##       ##        ##  #   #
##### ##   # ##   #  #    #### #####  ####   ##   ####   #### ##    ## ##     # ## # ##  ## ### ###  ## ## #### # # ## ##### ###
## ###### ##  ###### # # ##      # ## ##   # ### ##    #### # ### #  # ## ## ####  # #  ##  ##   ## ##  ##    # # #  ###       #
#          ## #      # #  ## # #         # ### #  ## ###       #### ##### ##    ## # ## ### ## # #  ### #  #########   # ### ###
## # # ### ######### ############ ### ## #  ##   ##    ### ## ##    ##    ## # ##  # #    # #  # ## # ####  ## # #   #####     #
#### # #      #####   # # # #   ###    #### ## # #  # #### #  ## ##  ####  #####  ## ## # ### ## #    ## ##      ###     ### # #
#    # # ## # #     # # #     #  #### ##    ## # ## ####   ####   ## ##   ### ########  #   #  ### # ###    ####   # # ####  # #
# ############### # # #   ### ##       ## #  ### ## ## #######  # #  #### ##  # ## ##  ## # # ##   # # ## #   ## # # #  ##  ####
# #       ## # ## # # # # ### ### ## ###### #########          ## # ##    ### # #     ### ### #### ###    ## ##  # ### ####    #
# ### ###         # ##### #    ####### # #####        #### ## ##### #  # ## # # #### ##    ##   ##  ### # #  ## #####   # # ####
###   #### # # ## # ##    # # ## ## #     ##   ## ### #    ##  ##   # ####            ### #####  ## #   # ##  ### # ## ##      #
#######    ### #  #############       # #  #####  ###### #  ##  ####### #  # # # ## #  ##     ######### # ## ####   ##  ### # ##
#       # ##   ###### #### # #  # # # #### # ### ##      # ######    #  #### # # ## # ##  # #     ##    ###       ##### ##  # ##
####### #  ### #               ## ### #           ## # # #  ##    ##   ##    # # ####  ## # # # #  ## # ##### # #    ########  #
### #   ## ####### ####### ### #    # ### ##### ######## ## ## ####  #    ## # #  ##  ######### # ##  ###     ### # ##    #   ##
#   ###### #  # ####     ###   ## # # ##  #     ##        #  ########## # #  # # ####  # #    # # ########## ############   # ##
###        ## #   #### #  #### #  ###  ###### #  ## #### ## ##     ## # # # ###### ###     # ## #   ##  ####    ## #  ##  # #  #
#   ## # # #  ## ## #####      ## ######## #  # ##  #     # ## # #      # #   ##       ## ##  # ## ####      ##      ###### # ##
# # #  # # ##             # ## #    ##       ## ## ## # # # #  # ## # # # # #  # # # # ##  # ##  # ##   # # ##  # # ##      #  #
############################################################################################################################## #
