# #############################################################################################################
#                  # # # #  ## # # # #  # # # ## # #    # # # #   #  #           ##        ##  # ## # #       #
### # # ## # # ###       # ##  #     ##     # #    ####       ### ## ### ## ######## #########    #     ##### #
#   ###  ########## # ## #  ## # ########## # # ####    # #####      # # ####  # ##  #       ## ### ####### ###
# ######### #     #####  ##      # # ##  #    # ## ### ##### ## #### # # # ### #  ## # #######          #    ##
###   ## #    ## ### ### #  ###### #  ## #### #  # #     ##   ####          ## # ##  #    ##   ### # #### ##  #
#   #  # ### ### ##        ## # #  # ##  ###    ## #### ### #### ###### ###       ##   ## ####   #######  #####
######     ### # ##### # #    # ## # ## ## ####  #  ##    #  ##   ## #   #### ###  ## ##### #  #  #### ##     #
#      ## ##   #  ## ###### ### #    ## ##  # # ## ### #### ##  ###  # #  ###########    ##   ###  # #    #####
## # #### #### # ##   # # #  ## ### ### ## ##      ##  # ## #  #####   ####      ## # ###### ## #### # ## # # #
######              ### #   ##  # # # # ## #### ## ### # ## # ##   ### ##   # ##### # ## ##            #### # #
# #  ##############   # ###  ## # #   # ##  ##  #### # # ## #  ## ## #  ## ######      # ## ######## ### #    #
#   ###             #     ## ##     ### ## ####  ##  #    # ##  # #  # ##       ##### ##     ###  #####  # ## #
### # # ## ### # # ## ## ### ## ## ###  ##  ####  ##   #### #  ## ##      ####### # #    # #   # ## # # ## ####
#     ######   # #  ####      # ##   ##  ##  ##  ##  #    # ##  #  ## ######   ## # ## #########         # # ##
# # # ## #############   # ## #  # #####  ##    ######## ## #  ## ###    # # ###  # #    ###   # # # ##### #  #
#####  #     #####     ###### # ######   ### ###### #  #    ## ## # # #### #   ## # # #### ## ## ######  # # ##
## ### ##### # # #### ##          ## ### # # #  ##  ##   ## #                ###  # #  #    #  #  # # ##      #
#  #       # #        #  #### ###### #         ####  ###  ##### ####### # ## #### # # ## #### ## ## #  # # ####
## ####### # #############     ## #  #### # #####   ## ##  ## #    ## ######## ## # #     # # #  #  # ####    #
#     #        ## ## # ##  # #  # ## # ## #   # ### #  ### #    #####    #  ##    #   ###       ## ##  ##  ####
#####   # #### #  #     #### ## # #  # #### ###  ## # ## #   # ###  # #### ######   ######## ####   ## ## ### #
#     ###### # ## ### #  ##  #    ##    ##  # ## ##   ##   ##### ## #   ##  # # ###  ## ## ### #  #           #
## ####  #            ##    ##### ## ###### # ##  ### #  #### #  ##   ###  ## # ##  ##   #  #  # ####### ######
#### ###   # # ### # #### # ## ## ##  # #     ###  #  ##      ##  # ### ## ## # ###    ### ## ## # ##  ### ## #
# #   ###########  # # #  ###      ## # #####  ### ## ## ######  ## ##     ## #  ## # #### ##  # #  # ###     #
#   #  ## # # # ###### ######## ##  #   ## #  ##   #  ##   #### ##   ### ###  ##  # #### #  # ## # ## # # # # #
###### #  #       # #  # #       ## ### ##   ##### ## #  ###  # ####  #    ## #  ##  # #   ##  # # ## # ### ###
# ##   ## ## #### # ##   ###### ##      #### # ##     # ## ## #  ##  ## ####  ## ## ## # #### ## #       #   ##
#  ### ## #####      ## ##   ######### ## #  #  #####      ##   ####       ## #             # #    ## ##   #  #
##  #     # # ##### ##   ### # ##         ## # ## # ## ###### ### ## ######## ## ####### #### # ######### #####
### ##### # # ## ## #### #      ###### ## #    ##      ###  #   # ##     ## #  # #     #### #   #       # # ###
#   #            #   #   ### #### ######  ### ###### #   ##   ### ### ####  # ##   # #  # # # #   # #####     #
### ###### ## ## ### ### # # # #         ## # # # #### #### #####  ## ## ## # ### ####### # # ## #####  #######
### # # ##### #       #    # # #### ####      #   # #   ##   #  ##    ##  # #       # # #      ####  ## ##  ###
# # #   # # ### # ### #### # # ## ### #### ## # ### ## ### ### ##  ####  ## # ### #       ## #### ##    #  ## #
#   ### # #  ######     ## # # ## ### # ##### # ##  #    #  ##  ##  #### ##     # ###### ### ##   #  #### ##  #
###       # ## # ###### #                 # # # ### # #### ####  # ## ## ## ######## ##### #### ### ##### #  ##
# # # ###           #     # # # ## # ## #     # #       #   # ##   ##             #     #  ## #      #  # ##  #
# ##### ########### ##### ### ###############   ###### ## # #  ###    # ### # # #   ##### ##    ## ### ##    ##
#  # #                     ## ##  # # #  #### # ## ### ## ### ## # ## #  ##############    #### ## ###  ### ###
##   # # ## ## ####### # #  ##### # # ##      #  # # #  #  ## #     #### # #  ## ## # # ####  # #### # ##     #
#  #   ######  ##      # # ######     ##### ####       ## ### # ## ####      ##            ##   # #    ## #####
# #### ### #####  # # ## #### ##  # #   ##  ##   #### ### ##     ###  ##### #### ### # # ##### ##   ####   #  #
###    #    ##   ## ####### #    #### #  ## #  ###### # #  # ###   ##    ## ## #  ######### ##  ###    # #   ##
###########  ### #  ##        # ###   ##    ## #      # # ##  ### ##  # ###### # ## # # # #  ##  ## #### ######
# ##### #### ### ##  ##### #### # ### ### # #  # # ##     ## ## #### ##### #                ##  ##            #
#                #  ##     #    #      ################ #### ##  ##   ## # ## ### ######## ####  # ## # #######
# ########## ## ###  # # # # # #########    ### #       # #   ## #  ###  # ## # #        #######   ####       #
# #          ## ##  #############   ## ### ## # ####### #   ###    ## ##        ##########  ##   #    ####### #
##### ## # # ## ### # # # # # # ###        ## # ## ## # # ### ## #### ## ##### #### #    ## ## ### #######  ###
#     #  ######## # #       # # # ###### # #    #                           ##### # # ####       # ###     ####
##### ##### # ##  #########            ### ####   ##### # ## # # ##### # ##   # #   # # ## # # ###     # #  # #
#     ###        ###        # ########  #       # #     #  ### #########  # # #   #        # #  #### # ###### #
#### ##   # #### # ## # ## ##### #  ###   ### ##### ## ###  ##       ##  ####   # # # # ## # ##   ## #  # ##  #
## ###########     ##########    ## # ### ###### ## #### # ##  ## ##  #####   ### ### # ## # #  ###  ##      ##
#   # #### # #####   # #    #### #        #           ##    ## ######  ###  ###########  # # ##   ####  ####  #
###           ###### # #### ##     # # ########## # # ## # ##    # ###   #####      ##########  #    ##    ####
#   # ## # ##                ####### ####         ###  # ##### ###   # #  ## # ###### ### #  ##### # #  # ### #
#######  ##### ## # ## # ## ## ######## # # ##### ##  ####       # ########        ##       ## # ### ## #     #
# ## #  ##     ## ######### #       ##  ######     ##  ##  ### #   # ## # ## ######## ### #        # ## ## ## #
#      #######  #### ##   # # # # #  ##  #     ## ### ######   # #    # # ##   #### #   #### # ## ## #   ###  #
# # # ##       ##       #     ###### ###   # #### ##   ##    ### ## ### #  # ###      ########  #  ########## #
# ### ### ## # ########### # ##  # # # ### #### #  ## #### #  ## #  # # # ##     ####  #  # #########   #   # #
####   ## ###### ###############           ##     ##    ## ####  ##          #########   ## # # ##  ## ## #####
#    # ## #   #         #   # ##### ### ##  ## ## ## # ##     ##  ## # ### #         ###    # #  ## ##      ###
## # ######## ##### ### ###   # ######   ####  #  ## ##### # ##  ##  #  ####### # ########### # ##  ### ##### #
#  #### ## #   ## #####     #          #  ##  ## ### ##    #######  ###       # #   #   ####     ## #   # # # #
# ##    #    #    ###   # # ## ## ### ### ### #### # #### ### #  ##  ## # ####### ### ###    # #      ###     #
# ##### ###### ##     # # ####  ###     ### ###    ###          #### #  #    #  #     ##  # ## # ## #     ## ##
# #         #  #  ## ## ###    ##   ## ##    ##### ###### # ###   ## # ## ##   ### ##    ## ## ###  # ### ##  #
# ### ### #   ### #   ######## ### ######## ## ##     ### #   ## ##  #  #  # #  ####  # ###  #   ## #  ##  # ##
### #########   ### # ##       #   ##  ## # ## #  # #     # # #   ## # ## ## # ##  ## #   # ## # ## # ### ##  #
##            ####  ##### # ## ## ##  ##         ## # ## #### # # #  # ####  #    ### # # ######  # #   # ### #
#  #### ### #### # ##     # ## #   ##    # # ## ### # ## #  # # # ## #  #### ### ## # # #   #  # ## ## ####   #
#### ##########     ## ########## ##  ## ### #    # ####   ## # # ## ##    #  ##    ##### #   #######  # ### ##
#     ##      ########## # # ## ###  ##   ##### # # #    #  # ###  #### ################### ###  # ###    #####
#### ########   ### ##       #   ## ##  # #     ######## #### ##  ##                  #  ##     ##   ## #     #
#    ## ## ### ##    #######   #     ## # ## ##### # ###  ###  ##  ## ## ## ## ######## #### ##    # #  # ### #
#### #   # # # ##### ##      #### ## #  # ####           ## ###### ## ## ## ##          ## ########### ##   # #
# ## ### # #          ##### ##    #  ## ### ## ### ### #       # # #  ## ##### # #########         ###  # #####
# #          ###### #       ## ## ##  # #      #   #   ### ##### # ## ##     # #   ## ## # ##### ### # ##     #
#   # # ############# # # #### #  ### # ### # ### ### ##         ###  #  ## ## # #            ##     ###  # # #
### #####             # # #    ##  ######## # #   ##  ## # # # #   ## ##  #  # ### ## # # # ###  # #   ## ### #
#   ## ###### # # ### # # # ## #  ##        # ## #### #  # # ### ###  #  ### #   #  # # # #   ## # # # ##  ## #
# # #         # # #   # # # #####  ## # # # # ## ##   ## ###   #   #####   # # # ## # ### # #  # # ###### ##  #
# # # # ### # # ##### ### # #     ##### # # # ####### #    # # # #  ##   ##### # ######   ### ## #   ## #  ## #
# # # # #   # # #       # # ## # ##     # # # #       # # ## # # ## ## #     # #     ## #   #  # # #    # ##  #
############################################################################################################# #
