# ##############################################################################################################################
#       ## ##     ## ## ## # #     ## # ##   ### ## #  # ##   #  ## #  # ##   ##   ## #  ## ####   ## #  #      ##    # ## #   #
##### #### ## #####          #####      ####  #  ## ## # #  # # ##  ##    ## #### ### # ###  ##  #### # ## ####  ## ### ## # ###
# ##  # #   #  ## ######## ###     ### ##  # ## ##   #     ## # ### ## #####  ##    #     ## ###  ##       #######  ##   #     #
# ### # ### # ##   ## #  #   ########   ## # ## #### ##### ####  ## ## # ##  ##  # ## #####   ## ### #####     ### ### #   ## ##
#   # # ##    ## ###  ##   # ##   # ###    #  # # ## ## ##  ##  ##        ##  ## ###  ##  ### #         #### ### # # #### ######
# #        # ##    ## ### ####### # # ####   ## # #   # ## #### #  ########## ##  ### ## ##     ### # #  ###     # # ## # #    #
# ## # ### #  # ####  # # # ## #        ### ##  # ###   ## ## # ## #      ##  ## ## #  #    ###   # ####   ### ### # ##   # # ##
#### ########    # ## #   # #  ###### ###    ## #  #  ###  ## #  #   ####  ##  #    # ## ####### ## ##### ######     ## ### ####
#    #   ## ### ## ## ### # ##          ### ##  ## ##  ## ##  ## # ### #######   ####          ###### # ###   #### ###       # #
########         # ## # #    ##### ####  #   ## ## ### ##  ##       #     # #  #   ## ### ### ###  ##    ####  ##   ## ## ##   #
#  ###### ###### # ## #   ####  ##### ## # #     # # # #  #########   # ### ## ### ## # # ######  ##  #### ### ## #### #########
## # # ######### # ##   #### ## # #      ### # #     #   ## # ## #  ##### # #  #####    ###  # ## ## ## ##  ##    #  #        ##
#  #   #            ## ####  ##   ######   # #######   ###    ## ##  # #    # ##   ####  ## ##  # #      ## #  ## # ## #### #  #
## ### ##### ## # #       ## ## #  ####  ########  ###  ### # #   # ## #### #    #####  ### ## ## # ######  # ##### ##    ######
#       ## ############## #  ##### #  ## #  ## #  ## ##  #### ## ##  # ## # # #### # ##  #  ## #       #### # ####     #########
#######     # #####       ##  ##   ## ## # ##  ## ##  ##  ##  ##  ## # ##   #  ##  #  # ## ##    # ##### #     ##  ## ##### #  #
### # #####   # #   ## ##  # ##  ###   # #  ## #  #  ##  #### ## ### # #### # #### ##   ##    # ###### #   #####  ##      #   ##
#     # # ### # ######  ##   ###   ### # # ##  ## # ##  ### #    ##    # ##    ##  ## ###  ###### ## # ###   ##  #### # #   ####
## ##     #     # ## ####### # # ###          ##    ###   # ### #### ### #  ##  ## #    ##    ### ## # # # ###  ### #######    #
##### # #   ### # ## ##            ###### ###    ## # # ### #    ##   ## ## ###### # ####  #### #  # # # # # # ###   # # ## ####
#     #### ##     ##  ######### ####   #### #######   #  ## ## ##### ### ## # ## # # ## ## # ## # ## #           # ### #  ###  #
## ##   ######### ## ### ## #    #   ### #     ## ###   ##  #  ## #  # #  # # ## # # ##  #        #    # # # ## ## # # # ###  ##
#########          # ##   # #### ### # # ##### ## # # #  ## ##  # ## #   ## # #       ## # ######## ########  #          # ##  #
# #  ###  ########   #  #    ##   ## #                ##### #  ## #  # #### # ## # ##### # # # ## #      ##  ## ## # ###      ##
# ##   #### # #    # #######  ### #  ########### ####  # #  # ### ## #  # #   ## ### ##         #   ######  ########   # #######
#  ### ###    ###### # # # # ## # ## ### # ## #### #  ##   ## ##     # ## # ###   #  ## #######   #    # ##     #  ## ##       #
# ## # # ####     #                  # # #      #    ##### ##  ##### # ##    ####   ##  ## # ####### ### ## ##### ###### ### # #
#        ## #####   # #### # ### ### #   ###### #### # #   ###  ## # # ## #### #  #####            ###    ###        ##   ## # #
##### ##          #####    # ######    #   ## # # ## # ###  ## ##      ## ## # ##  ## # #### #####     # #### ########  #  # # #
###   #  ## ## # ###    # ## #      ## ###             # # ##   ### ##  # ## #  ##  # # ####     ### ### #           ## # #### #
#   # ## ##  ### ##  # ##  # ## # #  ##### # #### # ##      ## ## #  #### ## ## ## ##      # # #  ##  ##   ## # ### #######  ###
### # ## #####    ## # ### #  ### ## #     # #    # #  #### #  ## # ###    # #  ##    # # ## ####### #### ############ # ## ####
### # ## #     # ##  # # #######   #### # ############ #      ##  #   ## ### # ##  # ######        #    ###### #   #           #
#   #  #########  ## # #  # #    ########  ##  ####  ######## ### # ###  ##    #  ##      ########### # ## ##    ### ###########
# # # ####       ##  ####   ## # #   ##   ####    ## ## #      ## #   ## ## #### #### # ###   #    #### #  ## # ## #   ### # ###
### # ##   ### ###  ##  # ########## ########## #    #    # ## ## # #### ## ###     ######  ### #### ##### ## ###    ###   # # #
##  # #  # ##   ####### # # ### # ## # # # ## ###### ######### #         ##     ###### # ##           ## #  # #### ##### ###   #
#  ## ## # ######            #  # #        ## #####      # # #   #######    # # #   #  #  # ####### ###    ## # ##  ##       # #
## #  #### #      # # # #### ##     #### ###  # # # ####     ###  # # #### ####   ### ## ## # ########## ###       ##  ## # ## #
## # ##    #### # ### ####   ##########    ##     #####  # #  ###        #   #######               ## #      ### #    ##### ## #
#  #  ## # ###  # #   ## ### # #      #### ###### ##  #### ##     ## #######  ####   ########## ## ## # ## #  #### ####   #### #
# ## ##  ###   ## #####          ### ##            ##       ### # ##      ###      ###   # # ########    ####   ##   #  #  ##  #
# ############ ######   ## # ### ##  ############# ####### ##   # ## # # ##   # # ## # ###     ## ##  ##### #####  #   ###  # ##
#  ##  ###   ###    ###  # #########   # # #  ###      ###  ## ####  ######## ###          ###     ##           ## ## ## #######
# ### ## ### ######  ### ####  ## #  #     ## # ######     ##     ##       ## ##  ## ## # ######## #  # ##### #  # ##          #
### # #  #      ####  ####    ### ######## ##     ###### ##### # ##  # #####   ##  # ## #    ### #### ### ########  # ##########
### # ##   # ## # #  ## #####  #    ## ###  #####          ##  # ### #    ## ###  ##  # # ##      ##   #    ## ### ##  ###     #
#     ########  # ## #  # ####   ##        ##     ##### ##  ## ###   # # #####   ### ## #  # # ##    #   ##  #   # ###     #####
## ## # ##  ###   ## ##   # ######  # ####    # ####### #####  ### # #####   # #   # ##### # #### ## # #####   ##### #####  ## #
####     ## # ###     ### # # # #  ######## # # #       # # ## #   #   ##  # # ## #### # ### ###   # #     ## ### ## ### # ### #
# ### ##    #  #  ###             #####     # # # # # #      # ### # #    #######          #   ######## # ##       #     ###   #
#   ####### ## ######## # ###### ## #   # # # # ### # ## # #####   # # ##   # ##  # # ### ## #      ##  ####### ##   ###     # #
## ### ###     # ## #######      #    # # # # # #   # #  #  # #### # #  ###    # ## #   ####### ###  ##### # ## ## ###   ## ## #
#   #      ###   #     # #  # ## #### # ####### ### # ## ##      # # ##   ## # ####### #### ##    ##          # ##   ######### #
### # ## # ##  #   ###     ## #  ##   # ##      ##  # #  #  # ## # #### ###  #### ##    # #  ## ##### # ### # #  #####     # ###
#     ####  ## ##### ## ## ##### ### ##  ###### #  ##### ## # ## ####   # ##      ## ##     ##      # #  ## ####       # #   ###
####### #####  ##       #   ##   #   ## #####   ## #     ####  #  ##  #    ######  # ## # #  ### # ## ##  #    ## # ## # # ### #
#######       ####### # ## ##  # # #### ##    # ## ## ##  ##  ########## #      # ## #  ### ######  #### ## ##  # ##########   #
#       #### ###      # ## ##########   ### ### #  #   ##  ## ##     # # #### #####  ##   #    ######  ############## # # ## ###
# # # # ###### ##### ##### #          ### # ##  ## ### ## ##  ######        #     ##  # # # # ## ## ##           #             #
# # ### #       #    ##    ### ##### ##      ## ## #   #   # ## ##   # # # ## # ##### # # ###  #       #########   ### # # #####
######  ### ###   # #### ### #####   ##### ###   ##### # # ###     # # # #  ###     # # #   ##   ## ##         ###   ##### #####
#      ##   #   # #    ###    #    # #      ### ##     ######### # # # ####  ## ## ####### ##  #  #  ## # # ################   #
##### ##### ######### ####### #### # # ## #   # ## # #  ##       # # #   ###########   ##   ## # ## ##  # # # ##       # ### ###
##  #### ##### # # #####       #   ######## # # ## ####  # # # # # ### #      ###    #### # ## #  ##### # #    # ### ### # #   #
#  ##     ###    # # # ##### #   #  ##      # # #  #    #### # # #  ## # # ##     ## ###  ###  ## ##  # # ## #     ####      # #
##  ##### # ## #             ## ### ### # # ########### ##   ######  # # # ## # #  # # ##  ## ##     #### #  ### #  # # #### ###
###  ##        ### ### ### #  ####  # #####   ## ###    #### ##     ## # #  # # # ##    # ####### ##    ######   ##        #   #
####    ## ### ###  ####   # ##    ##  #### # #  #   # ##     #### ##### # ## # #  ######## ###   #  ##  # ### # ## ######## # #
## ## ######   #   ##    # #######  ##  #   ####   # #  ### # #     # #  # ## # ##            ### ##  ##     # # ##    ##### ###
#     ## #   # # #  ## # # ##      ####   #  ##  # # ## ##  # ### #   ## ###  # ## ##### ## #  ##### ##  # # ### #  ####   #####
## # ##    # ##### ##  # #  ##### ### ### # #### # # ##  ## # #   ## ###   ## # #    #########  ## #########   ####      #  ## #
#  ####### ###      ## ### ###### # # #   # #    # # #  ##  # # # ##   # ###### ## #   ###   ##  #       ##  #####  # # ###    #
#####      ###### #  ####  #      #     # #### # # ####  ## #####  ### ##### ##### # #     #####   #####  ##     ## ######  ## #
#   # # ##   ##   # ####  #### ## # # ### ###  ### ##   ##  ##    ##          ##   # # # #     ###     # ### # # ##    # ## ## #
###   # #### #  ### ## ##################   ##  ###### #### #  ## ## # ## ###  # # # # ### # #  ## # ##### # # # #  # ##     ###
#   # ###    ##  ## #  # # # ##  # # #    #####   ## # ##   ## ##  ###  #   ## ### # #  ## # ##  # #       # ###### #  ### #   #
## ######## ##  ##  ##        ##       ## ## #### ##   #  # #   ##   ## #####   ## # ##  ####### ### #### ##   ###  ##  ## ### #
#   ##       ## ####### # # #    ## # ##        ###### ## # # # ### ##      ## ### # ###    # ######    #### #   ###### ##  ## #
####### ## # #### ######### ## #  ###### # ## #  ##    ## # # ###   #### # ##    ### #   ####      ## #    # ### #    # ## ### #
#        ##### ## # ##       ### ##      # ## # #### #  # ### #####    ###  ## #  ###### #    # ##  # # # ## ##    ## # ##   # #
#### ###### #        ##### ###   #### # ##  # # ##   ## # ##### ##  ########## ##   ##     ## ########### ## ## # ##### #  # ###
###### # #  ######## ### ###   ###    ###  ## #  ###  ##### ##     ##### ###    # #  # # #  #        #  #### ## #   ### # ######
#   #      ## #              ###### #   ## ## ## #   ##     #  ###     #   # ## # # ## # # ## ######## ### ###  # #   # #      #
### #### #      # # #### # # ##     # # ## ## ## ########## ## #   # #   ### ## # ###### # ##    # # #     #### ### ### # # ####
#        ## # # ######## ######## # ### #  ##  # ##   # # # ##### ## ## ####### #   ##   # ## ##       ##### ##   #   # ###    #
###### ###### # #        ## #   ###   #### #  ####  #             ## ##       # # ###  # ###   # # ###        ## ## ###  ## ## #
#       ##    # ### # ## ## ## ##   # ##   ## # ############ #### ####  # # #####   #### #   # ###  ## # #########    ## ## #  #
###### ### # ###### # #  #        ### ## #### #  # #  #      ###   #### # #   ##  #  ###### ##   ## ## #       ######  # #### ##
#        ######     #### # # ## # ### #####   ## # ## #### ###   #    # # # ########     ## ## # #  ## ## ## ### # ####### #####
#### # ###  # #### ##    ### #  #   # #     # ##           ##  # ## ### # #       ## # ###  ## #### ## ##  #####       ###     #
#    ###### # # ####  ##  ## ## ## ###### # # #### # ##### ### # #    # ### ### # ## #   ##  #  ##  ## ## ##     # # ###   # # #
# # #### #       ######  ##  #####  ##    #####    ######   ## # # # ## #    ########## ##  ## #### ## #   ### ####### # #######
###### # ###### ## # ###  #### ##  ##  ## ## ##### ##     # ## # # ###  ### ## # ##   #  ## ## # ##  ### # # # ## #### #       #
#  #                     ## #     ##########       #  ### ###  # # ######           ### ##  ## #    ###  #         # #   # # # #
## ## # # ### ## # ## # ### ### #   #### #   ## ## ## #     ## # #   ##   # # # #############  ### ###  ## # # # #     ####### #
#     ####### #  #  # # ##  #   ## ##      # #  ## #  ## ## #  # ## #### ## # #       ##    ## ##    # ### # # ### # #  # ######
# ## ##       ## # ## #  ##   #  # ### # ### ## ## # ##  #### #####    # #  ##### ###  # # ##  ## # ####   # #   ######    #   #
# ####### # # #  #  # ## ## # ## ### #####   #  ## #####  ##  # #   # ##### ###     ##   ##### ## # #  ### # ## ### ##  #### # #
###       # #### ## ###  #  #  # ### #  ### ### ## ### ##  ##   # # # ##      ### #  ###  # ##### #   ## ### ##      ##      ###
#### ### ####    #    ## ## # ####   ##     #    # #      ### # ### #  ## # # ##  ##  ## ## # # ### #     ## ## ## #### # # ####
#    ##  ##   # ### #### #  #   ## #    # # ### ###### ## # ###  #### ##  # #  ## ## ##         ### # # ###  ##  ### #  # #    #
### ####  # # ### #    #### ## ##### # ####  #### # #  ##     # ## ####  ## # ##  #   ## ######   # # #   ##  ###### ## ### ####
######   ######## # ######  ##  ##   #  #### # #  #   ##  ## ##       ## ## #  ## ## ###      # ### # # #  ##   #    ## ###### #
# #    #  ###       ##     ##  ##### #### #  # ## ## #### ##  ## ####### ## # ##  ##   # # # ##  ## # # ## ## #   ##  #        #
#   ## # ## # # # #  # ## ####  ##    ##    ## #       ##  ## ##     # # ## # ###  # # # # #  # ##  # # #  ## ## ##  ## # # # ##
## ##### ##   # # # ## #   ##  ##  # #### # #    # # # ## ##   # ## ## #### # #   ## # # # # ##  #########  # ## ###  # # ######
## #     ## ### ###  ### ######## ##  ##  # ## # # # # #   ## ## ##       # # ###  # # # # # ###  ## # ##  #####   # ## # ## # #
#  #### #####   ##  ##     ## #   ### ######## ### # #####  ###  ## # # ### # #   ###### # #   # ##     ##   ##  # #  # #    # #
## #     ##   # ### ### # ##    #  ## #      # ##  # ##    ##   ##  ###   # # ###  ## ## #### ##    ####### #### # # ## ## #   #
###### #  ### # #     # # #  # ## ##########    ## # ## ## ## #  ##   ## ## # ####    ##   ## ## # #####  #### # ### ## ## ## ##
#      # ###  ### # # ### ## ####   ###      # ##  # #  #   #### #  #  #  ##### ## ## ## # #   # #       ### #    ####  #  ## ##
## ### # # ## ##  ### ########    #   ###### #  ## # ## # #   ## # ######  ##       # ## #### #### # # #     # ##    # ### ##  #
#  #   ###    ######     ## ##### # #  ##    # ##  # #  #### ### #     ## ###### ## #  #  ##  # #### # # # ### ## # ####    ## #
## ## ####### #      # # ##  ###  # # #### # # ## #####  ##  ##  # ###### ##      # # ## ####      # #####   # ## ###    ##  # #
#   #### #### ## ### ###  ## #   #### #    # # #      ##  ## ## ##      ###  # # ## ###     ### ####   ### # # ##   ## # ## ## #
## ##         ## ##   ## ##    #    # # # #### ## # # #  ###### #  #### ##  ## #  #  ## # ###      # #   ##### ## #### # #   ###
#  ### # ## #  ###  ######  # ## ## # # #  ### ## # #### #      ##  ###  ## ## # ## ##  # #### ## #### #    ##  # ## #######   #
## #   # #  # ##   ##  ##  ## ## ###### ## # #  # #   ## ## # # ## ## #######  #  #  ## # #    ##    # ### ##  ##         ### ##
##### ####### ## #  ## #  ##  ##     ##  ###   ## ###  # #  #####      ##     ## ## ##  # # # ##  ## #   # ###  # # ## # ##    #
#     ##       # ## #    ##  ##  ## #### #   # ##  ## ## ## ##    ## #  ## # ##  ##  # ## # #  ##  # # # #   ## # #  # #  ## # #
############################################################################################################################## #
