## ############################################################################################################################################
## # ##      ## # ## ##  # ## # ## ##     ## # #   # ##  # #   ## ##  ##  ## ##  # # #      # # # # #     ## ## # #     ## # ## # ## ## ##  # #
#       #### ##    # ### #  # # #  ## #####    ### #  ## # # #### #  #### #  ###       ## #           #####       ## ####    ##    # #   ## # #
## ## #####   #### # # # ## # # ##     # #  ###### # ##    # ##   ##  # # ## #   ### #  # # ## # # # ##  #  # ## ### #  # # #### ### ## ##    #
########  ### #                    #####   ### # # #  ### ##  ## ##  ## # ## ## ########### ## # #######   ##  ####  # ## ### #  # # ## #  # ##
# # ## ##       # ## # # ## ######     ### ##  # # # ####  ##  #  ## #  # ##  # #     ## ##  # #### # #  # ###### ## #  #  #  ## # # ##   #####
#       ### # ###  ##### #  #      ### #   ### # # #  # # ##  ## ##  # ##  ##     # #    #########  # # #### ##   ## # ## ## ##  # #    ### # #
### ###  ## # ########## # #######  ######           ## #  ##     ## # #  ##  # ########## # ##  # ##     #   ## ##        # ### # # ###### # #
# ###   ##  # #      # ######    ## # #  ########## ### # ### ###### # ##    ##   ## # # # #  # ## ## ##### ###  #### # ##   # # #            #
#  ####  ########### # #### ### ##      ##       #    #   # # #### # # ## ##  ## ##  # #     ##  # #  ## #    ##  ### ##### ## # # ######## # #
##   ###  ## # #         #   #   ## ############ # #### ### #    # # # ##  ##  #####   # #####  ## # ###   ##### ## # ### # ## # # # ##########
#  #   ##  # # ######### ### ### ##   ##   ## #    ##   # #   # ## # #    ####  ##   ###   # ##  # #   # ### # # #      # #### #           # ##
# ####    ##   ##          #        ###### #  ####  ## ##   #####  #   #### ###### ####  # #  ## # # ### # # # #   # # ## ## # ## ### ######  #
### ### #  ### ###########   # #### #  ##  ## # #  ##   ## ### ### ###    # # ###       ## ##  # #    ##   #     ### #### #         #### # # ##
#     ####   # #  # # #  # # ### #  # ##  ###   # #####         ## ##  ####       # ## ####### # # ##### ### ###  ## ## # # ## # ##  ##       #
##### ## ### # ##   # ## ######    ## ### # # #    ## ## ##### ### ### ## # ##### ###### ## ##       #     #   ##### #  # #  # #  ###### ######
# #    # #      ###       ####  ##  #  ## # ###### ## #      ### #  #           # ## ###  # ## ### #   # #   #   # ####     ## ##  ## #       #
# #### # #### ### ##### #  # ###### # ##     ##     # # # ##  ## ## ## ####### #####     ## #    #### ## ## ######  ##  ###  #####      # ## ##
# ##   # ##   ##   # ##### # ###  # # ### ######### # # #######     ##       ### #   # # #  # ##### ######### ## ##    ###  ###    # ## # #####
# #### #    ###### #  ## # # # ##      #  ## # #    #    ## ### ### ## # # #  #  # ####### ## # # #  ####  #   # ## #####  ## #### #### #     #
#  ##  # ##  ##      ##      # ####### # ##  # #### # ##    # ####     ######## ## ## ##    # # # ##  ##  ## ###  #     ####  # ##    # # # # #
##    ######  ### ## ### # #       ###    ## # ##   #  # # ##  ##  ###  # # # #        ####        # ### ##  ####   ## ## ### #    #### # # ###
##### # # ###  ####  # ########### # # ## #     ### # ####### #### # #### #     # ## ###  # #### #        ## # ## #  ####   # ### #########   #
# # #     #   ## #  ##  # # #          ######## # #     # ##   ##     ### ## # ####    ##      #### # # ###     ####    # ### ###       #### ##
# # ##### ### ## ## ###     ### # # # ## #        ## ####  # ###  # #   # #  #   #### ##  # ##### ### #     # #  # # #### # #   # #######  #  #
#    ##             # ##### ######### ## ###### # ## #  ## #   ## ### #     ####   ####  ##   # #   ##### # ####      ###     ##### # #   ### #
## ######### ## ### # # # # # ## # #   # ##     ###    ### # ###   ###### #    ##### #  #######   #### ########## # # #   # #           ### ###
#    # #     ## #           # #  # ## ##  #####  ### ### # #   # ###   ###### ###  # # ##  # #  #      # # ## #######   ### # ## ## # ####   ##
# # ## ### # ## ###### # ## # ##      #  ## #   ##     # # # ###     ### ######   ##      ## # ### # #         # # ## #   ###  #  # #####  #  #
# #      #########  ######       # ##   ##    #  #### ##   #   # #######  # ##### #  ######      ### # # ## ##      # # ###############   ### #
###### #### # ##   ##   ### ### ## ####    ## ##  ##   ## ## ###    #  # ## # # # # ## ## # ############################# #    ##  ##   #######
#   ## # #    ####  ###     ######## #  ## ## #  ##### #   #  ## #### ##  #   # # #            ###  # # # ##         # #    ###### #  ### ## ##
###      ### ## ###   ##### #  ## #    ###  ####  # #    ### ##   #      ## ###     ## ### ## ## # ##        # # # ###   ##     ##   ####  #  #
#### # #  #  ## # ## ### ##### ## ### ##   ### ## # ####  ##    #   ######   ## ######   ######  #    # # # ## ##### # ##### ####  #### # ## ##
# #######   ##  # #      # # #  # # ###### ##            ##  ##### ##  # # ####    # ###     ###   # ## # ###    ##       ##  ####    # #     #
# # # #   #  ## #   ## #     ## #    # ########## # ## #  ## # # #### ##        ##    ### ##  #  # #  ######## #    # # ####### #  #### # #####
# #     ####      ######## #      ##      ## # #  # ## ## #       # # ## ########  #### #####   ## ##        ### # ## #      ## ## #  # #     #
#   ###### # ######## ##   ## ########### ## #   ## #  ##   # #####             ##         ## ######  # ## ###   ####### ###### ## # ## # #####
# # ##       #        ####  ### ### ###        # ## # #### ##   ### #############  # # ###### ###########  ######## ###### ## # ## #       ## #
# # ## # # # # # ####  ######           ###### # #  # #     # #      # ## # #############   #   ##    #### # ## #     # ## ## # #    # ###    #
# #  ##### # ######## ##  ###### ## ## ####### #### #### # ## ## # #              # #     # # #    #### #### ##   # # # ##        # ## ### ####
######  #  # ###       ## # # ## ## ## ##      ##    ##  #  # ## ### #### ######### # ############## #   ###  # ##### #  #### ########## #   ##
## #### ######   ### #           ## ###### ## ### # #### ## # ## ##     #     #  ## #   ## # # ## ## # ### # ## # ###### # #  #     # ## # #  #
#       # #  ######  ## # # ## # ##    ##  #### # ###  # ## #  # ## # #### #### ###   #  #         # #            # ## # # ## # #####    # # ##
# # ###   # ## ## ##### ### ## # #  # ##  ##          ####### ## #  #    #    #     ###### #########   # # # # # ##  # # # #     #    # ####  #
######### # #       ##  ##   ### ## # ### #### # ## ### ##    ##### ### ## # ## ### ## # #           ########### #  ##   # ## #### ######  ####
## #  ##      ##### #  ##  #   ###  # #   #    ###       ####  ## #   ######### ###        ####### #  # # # # #### ##### # ##    #   # #  ### #
#  ## #  ### ###      #### # ####  ##### ## ## #   # ### ##   ##    #### ## # #   ####### ## #   ###### #      ##   # ## #  # ##   #   ##     #
# ##  # ###  #   ### ##  # #  ##  ##     ####### # #   #  ## #### #             #### # #####   #### ##  # ######### # ## ##    ## ####### #####
#  ##   # ## ### #    ##   ## ## #### ## #   ##### # ### ##    ## ## #### # ## ###      ##   #       ## #  ## # ##    #  ## # ######  # #     #
##    ###  ###   ## # #### ## ##   ##  #####   #   #  ####### #####     # #  #   ## # #  # ###### ####    ##     #### # ### ###    ##   # #####
### # ##  ###### ## # #    ##  ## #######    #   ### ## #  ## # ##### ##### ####    ####        #### ### #### #### #    #       # #####     ###
#   #####  #     ## # ## ###  ##    ###   #### # #        #####        # ##    # ##### ## ########   # #  ##     # ### ## ########## ## ### # #
# # #   ##   ## ##  # ##   ##  # # ##   ########### # # ### ###### # #    # # ##        #### ### ## ## ##  # ##### # # #    ##  ## # #   #### #
### ###  ### ##  ## #  ####### ### ## # #    ## #   # #       ###  # # # ## ###### ####  ##    # ## ## ## ## # # # #     ##### ###     ### ## #
##  ####      # ##  ## ####      ###  # ## #      # # #######   ## # # # ##   # ##########  #### #   #             # #####      #  # #        #
#  ##    ### ## ## #####    ## ############## # # # # ## #  # # ## # # #  ###          # ##   ## # ### ### # # # #       ## # #   #### # ######
## ### # #   ####   ##   # ##   ## #  ###     # ### #      #### #  # # ##   ## # ## ##      # ##         # # ### # # #####  ### #    # #     ##
#   #### ###  ##### #### # ### ##    ## ##### # ##  # # ########## ### ## ###  # ###### # # #    # ## # ####   ### #    ###  ##### ####### #  #
#####      ##     # #  ##### # ### #  # # ##### #  ## #     #   ##   ###    # ##    ##  ### ### ## ## # ##   ###   ### ##   ## # #     ### ####
######## #### ## #####    ##    ##### #         ## #  ## #### ###  # ##  # ## ## ##  ##  ## ################  #### ##  #  #      # ##### ######
#    #    ##   #    ### #    ## #       ## # # ###### ######   ##### ## ## ##  # ### ## ##     ## ## # ##    ## ##  ##   ## # # ##        #   #
# ##   # ##  # # # ## # #### ## ##### # ###### #             ###   ###   # ## ## #    # #  # #          ## # #  ## #####  # # ####### ## ## ###
###  # #  ## # ### ##   ##   ## #     #   ##   ### # # ## ##     #   ## ##  # #### # ## ## # # ###### # #  #   ##  #     ## #   #  ######## # #
### ## # ##  #   # ### ##  # ######## # #  ## ##   # # ## ### # ## ####  ####  ##  # ##### ###      ### # ## #### ### ## ######## ## ##       #
#   #  #  ## ## ## #    ## # # # ###  # # ########## ####   ###  #    ##    # #### #  ##     ## # #   #####     ###   #   ## ## #     # ## ## #
### ## # ##   #### # ## ## # #       ## ####            ## ###  ## # ##### ####    ##  ### #### # ###     ## # ##   # ###         # #    ###  #
### #### #  #  ##  # ##  ##### ##### ##### ##### ## # ###  ##  ##  # ##  #    ## # #  ##      # #   # # ###  #  ### # #   # ## # ## ## #   ####
#      #### ##  ## #  # ### #  #       ##    ###  ###   ##  ##  ## #  # ## # ### #### ### ##### ############ ####   # ## ####  # ## ## # ###  #
### # ##     ## ## # #####    ##### # ##  ##     ##   #  ##### ##  ##    ##### #####   ##    ##      # #   #    ## ## #     ## #  ###  #     ##
#   #  ### ###  #### #     # ##     # ### ### # ##  # # ##      ## ## ##    #   ##   # ## ##### ####     #### #### ## # # #### ##   ## ## ##  #
### # ##     ## # ##### # ####  # ### #    ## #  ## ######## # ##   #  ## #   ###  # # ##  ## #    # # #   ##    # #  # #####  ## ####  ###  ##
#   #  ### ###  #       # #    ## ###### ###  ## ##    ##    # ### ### ######   #### #  ##    ### ########  ## # ### ##   # # ##     ##   # ###
### #####    ## # # ########## #  #      ### ### ## ##  ## # # #     #      # ### #  # #### #  #### ##  ########   # ### ## # ## # ########   #
#    # #  # ### ### ##     ##  ## # ## ###   #   ###### ## # ### # # # ## #####     ##  ##  ##       ##    ##    # # #      #  ### ##   #######
### ##   ##   # ##   ## ##    ############## # #   #  #  ### #   # # ####     # # #  ##  ##  ## ## #  # ##  #### ####### # #######    #       #
#    ###  ## ##  ###### ## # ##              # # #   ### #   # # # #    # ## ####### ### ## ##   # ##    ##   #####  ### ###     ## #### # # ##
# # ##   ##   ## ##      ### ### ## ## ### # # # # #   #### ## # #### ###  ### # ##   ##  # ### ##### #######       ##       # #  #    # ###  #
# #  ## #### ########## ###   ## #  ## ##### # # # # #### # ## ####     ##  ##   ### ##  ##  ##   ##  #    ## ### # ### # # #### ## # #####  ##
# ## #   ##    ##       ##  #########  #     ##### ###    # #     # # #####    #  ##  ## ## ### #  ## # # ##    ### #   # ###  # ## # ### #####
# #### #  ## ######### ########       ## # ###         ###### # # # #     # # ## ##  ##  ##   # ####    ##########  ## ##     ## ## #  #      #
# #    ## ##   ## #     ## ## #########  # ### ## # ##      ### # #### #### #### ### ### ## # #  # ## # ## # ### ##### ## # # ##  # ##   # ####
# #### #  ## ###    ## ##     # #       ## #   #  #  # # #####  #####    ##  # #  ##   # ## # ##   ## #           ##   #  # # ## ## #  ########
# #### ##  #   #### #   ## ##     # ## ##  ### ## ## ###  ## ##  ##   # ####   # #### ####  ###  #  # # # # # ####### ## ####### ## ## ## #   #
###    ## ## ###    #####  ##### ## #  ### ### ##  ######    ## #### ##  ##  # # ####    ##   ## #### # # ###      ## ##     # ###  ##      ###
#### # ## ##   ## # ##    ## #   #  ## #   #    ##  ##    ## ## ####  # ##  ####  ##  # #### ##    ## # #   ########  #  # #     ##  ## # #   #
# #  # #  ## ###  # ## # ##    # ## #  ## ## # ##  #### # ## #   ##  ## ###   ## #### #  # ##### ###  # # #   ##   ## ## # #### ######### # # #
#   ## ## #    ## # #  #  ### ## ## ## #   ### ## ### ### #### #  # ###  ## ####  ##  ## # ### #   ## # # # #    ######  ######     #  #### # #
# # ## ## ## ###  # ## # ######  ## ##### ##    ####       ### # ##   ## ##    # #### #      # #####  # # #### #      ##      ## #### ##  # ###
# # ##### ## #   ## #  # #      ##  # #    ### ### ### # #   # # ## #  # #  ####  ##  ## # #       # ## #   ## # ### #### # #  # ## #  # ##   #
# #   ##  ## # #  #### #### # #  ##   ### ##        ## # ## ######  # #####   ###  # ##### ## # # ##  # # ######  ##### # #### #      ##  # ###
# # ###  ######## ##     ####### ### ##    #### ###  # # ##     ### #  ###  #   #### ##    ## #####  ## #    ### ## # # #   #### # ##    ##   #
# #   ##  # #      ## #### ###    ##  ### ##    ### ## # #  # ### ### ##   ## #   ## ## ## ##    ###  ##### ##          # ###    #### # ### # #
# # # ## ##   # ## #  #     #  ##  ####    ####   # ####### #      ##  # #  ### #  # ## #   ## #   ##  # #   ### ### # #########  # # ####  # #
# # # #   ## ## ## ########   ##  ##    # ##    ##### ##    ## # #  # ########  ## # ## ## ##  # #####   ## ##    ## #   #    ###   #    # ## #
# # # # ######   ###        # ###  #### #  ## #    #   # ##  # #### # # #    # ##  # ## ##  ## # ##  # # ##  ### ##  ###   # ##   ###### #  # #
### # ### # ## ######### # ##  ## ##    ##### ## ### ####### #   ####     # ##### ## ##  ##  ###    ## #####  ##  ##   # ###### #      # # ## #
#   # ##     # # # ## #### ## ##  #  ##  ##   #           ## # #    # # # #     #  #  ## ## ###  # ##      # #### ## # ###  # # # # ######  # #
# # #  ## ##   #   #   ##  ##### ####### ## # # # # # ######## # # ## # # ## #### ### ## ## ##  ###### ## #####   #  #  ## ## # # #   # ### ###
# # # #####  # ### ### ###     # #  # ####### ### ###       ## # #  # ###  #    #  ## ## ## ###   ## # ## # # ##### ###       # # # #    ##  ##
######## ### ###           # ######    ## ##   ##  ### # ##  # # ## ###   ## # ## ###  #  # # # ###     ###      ## ##  ##### # # # ####  ##  #
#            #   # # ## # ##  # # ## #  # #  #  ##   ### ## ## # ##  ## # #### ## ##  ## ####     # # #     # ####  ###     ##### #    # ### ##
################ # # #  #### ##    # ##     ## #### #### ## #  # ## ##### # ##### ## ###  #### # #### ## ## #   ### #   ## ### #### ## # # ####
# # # ## # ###   ### ## #     ####   ### ##  # ##    # ###  # ##  #  ##         #  # ##  ##    ### #  ## ## ###  ## # # ##     # ####  # # ## #
#          # ## ##   ## ##### # #  # #    ## # #####    ### #  # ### #### # ########  ## ## ##     ## ##  #  ### #  ###  ## ##      ## #   #  #
#### ##### #     # #  # #       ## # ## # ## #  ##   ##  ## # ##   # # ## #      ######  ## #  ### #   ## ##   ####   ## ##  ########### #   ##
# ######     ## #### ##### ## # #  #### #  # ## #  #  ## ####  # ### #    # ## ### ## ##### ##   ### # ##  # #  ##  ####  ##           # # #  #
# # #    #####   ##   ## # #  # # ### # ######  # ###  ### ## ##   ###### ####          # #  ## ##   #  ## # ##  ##  ##  #### #### ######### ##
#     ## ###   # ### ##    ## ### #         ### ### # ###   ###  ###  #    ##  # # ## #   ## ## ## # ##  ###  # ##  ### ## ##    #    # # #####
## # ##  #   # #  ######## ## #   ### # ###   # #       # ######   ## # # ###### #### ## ###### #  #####  ## ##  ## ##  ##    ## ## #         #
#  ##### ## ## ##  ## #    #  # # ##  #   ## ## # # # #        # # #    #    #######  ##      ####  ##   ###  # ###  ## #  # ######## ### #####
#####     # ## #  ###   # ### # # ### # # ##  # # # # ## # # ### # ## # ## #       ## ### ######   ##  #   # ##   ## #######        #   #     #
#     ## ####  # ## # # # # # # # #   # # ## ## #####  ### #########  # #  ## # # ##  #        # #  ## ## ##  ## ##   ##     #### # # #### # ##
## ####### #  ## #    #####   # ### # # # ##  # #     ##    ## ##  ####### ## ###  # ## # # ## ### ########  ##   ## ##  ###    #####    ######
#####        ####### ####### ## ##  ### #  ## ##### #  ## #       ## # ##  ##   ## ###### ######       #  ##  ## ##   ## #   ##  # ## ##### # #
# # # ###### ## # #   # #    #   ## ##  # ###  # ##### ## ### #####     ## ## #  #    ##    # ##### #### ##  ##  ### ##  # # ## ##  #   #     #
# # ####     #    # #   # # ### ##  #  ##   ##   # # # ## ##     ## #####   # # ######### #       # ##    ##  ##  ## #  ## # ## ## ####   # # #
#        ## ## ##   ## ## # #    ## ##  ## ##  # #     ## #  # #        # # # #         # # ## ## #    # ##  ##  ##  # ##  # #        ## ## # #
############################################################################################################################################# #
