## ############################################################################################################################################
## #       ##    ## ##    ##  #  ##  # #   #  ## # # #  # #  ##      # # #   # # # #  ## ## ##  ## #  # # #  # # # # ## ##    # ## #    # ##  #
#  # #####  ## ####  ### #### # ##  ## ### ##          ## # ##  # #### # ### # # # ##     #  ## ##   ##   ##   #   #  #    #### ## ## ###  ## #
## ##### ## #     ## ##   ##  # ## ##  # #    ###########      ##### # # # # # #    #####   ##     ###  ##### ## ### ## # ##### ## ## # # ### #
#  ##    #    ###### #  #####   #   ##     ## #### #### #### ### #     # # #   # #### # # ###### ####  ## ##  ## # # ## ###     #  ## # # #   #
##  #### #### ## ##    ## ##  ### ###########    #      ##   ### ### ### # ###    # # #    #  ##  ##  ###  ## #    # #    #### ## ##        ###
#  ###        ## ##### ##  ## ##   ## #  #    #### #### ### ## #      ##   ##  # ##   ### ## ##  ##  ## # ##    ####   ####    #     # ## #   #
## # ## ##### ## # ##   ## #  ####  # ## ####  # # # #### # #  ## ## #####  ## ###### ##  ##  ## #  ### # #  ####  # # # #####   ## ####### # #
## #  #####         ## ##  ##  # ## # #   # # ## # # # ## # # ###### # # ## #   # ##   ## #  ##  # ##   # # ####  ## ###  ## ## ##### # ##  ###
#  # ###  ######### ##  ## #  ## #    ###            # ##   # # ##   # # #  # ### ####  # ## ###    ###      #   ###  ## ###  # # ###    ## ###
##   # ## ## #####     ##  ## ##   ######### ## ######  ###     ## # # # ## #  ## #  ## # #  #   ####   ###### #   # ##    ## #     # ####### #
####             ##### ### ##  ## ## ##    # #     ##  ## # ## ##### # # ##   ###   ##  # ## ## ##### ####  ## ##### ## ##### # #####   #  ## #
# #  # # # ##### # ###  #   ## #  ##  #### ##### ###  ##     ### ##    #  ### # # #####      ## #   # ## ##      ##  ## # ##    # # # ### ##  #
# ## ### ####  #   # ## # ###    ##  ##     ##    ###  ### #  ##  #### # ###       ####### ###    ###     # ########  # # ## #### #   # # ## ##
# ####   ## ## ###        # #### ## #######  ## #  #  ## #### ## ## ##     ## ####  ## #   # ## ##### ##### #  # ##  ## # ## ## # # ### # #   #
#  ### ###     # ###### #    ##   # # ##  ##  # ## # ##  ###  ## ##  # #########   ###   # # ## # #   ####    ##  # ### # ##  #     ##    # ###
# ## #########   # # ##### ###  # #   ###  ## #### #  ##   ## #   ## #  # ## # ###   # ###   ##     # #  ## #### ## ##       ## ######## ## # #
# ##  ##  ###  #     # #    ##### ## ##   ##   ##    #### ##  # ###  ## # ## #   # ######  ###  ######## ##  ##   # #  ## # ### # ##  ## ## # #
# ## ##  ## ##### ## # ## #  # #      ## ### #### ####### ###    ### #    ## ### #   ## ##  ###    # #    ##  ## ##   ####### #    # ##  ##   #
# ## ###  # #  #####   ##### # ### ####  ##  # #  # # ##   ### # # # ####  # ##    ###  ###     ####   ####  ##     ####   ## # #### ### ## ###
# #    ##     ## #   #   ##    ##   ##  #### # ##     ## ### # # # # # #  ## #  #### ##  #  #######  ###  ## ### ######  ###  # ###   ## ## # #
# ### ##### #  # ###### ######  ## ####  # #    ### ###  # # ### # # # # ##    ##    ### ##  ## # ## #### ## #   #### ## # ## # # # #### ##   #
# #     ##### ##   ## # # ## ## #   #### # # ####       ## # ##           ### ##  # ## # #  ##         ## ##   # #  # ## # #         ##     ###
# ## # ## ##   ###  # # # ## ## ###  ##       # #### ####  #  ########## ## # ## ## ## # ## ### ###### ## #  ##### ## ## # # ########### ######
# #### ## #### # ##       ##     ## ######## ##    #  ####   ##  #### #  ##   ## ####  #          #  # #  ## # ##      #          ## ##       #
#  ##  #   # # # ### ## #    ## ###  # ###    #### # ## ## ###  ##  # ## #### ##  ##  ## ####### ## #####      #  ####   ####### ##   # #######
## ###   # # # # # # ## # ####   #  ## # ####   ## #    ## # ##  ##       ###  ##  ##    ##### ###      ## # #   ##  #####  # ####### # #######
#   ### #### # #     #### #    #   ##    ##   ###    # ##     ##  ####### # ## ## ### # ##      ### ######## ###### ####   ## # # #           #
###  ##   ## # ### # # ###### ####  # #######   ### ######## ####  ## # # # #   # # # ###  ####  ## ## #####   # #     ## ##    # # ### ##### #
#   ##  #### #  ## ### # # #### ### #   # # ### # #   # # #   # # ##  # # #   # #      ###   #####   #  ##   ### # ######    #### #   #     ###
### ###   #  # #####        ###   # # ### # ##      ### # ## ## # ### # # ### ##### #### # #    ## ### #####     # # ## # ##  ##  # ###########
# #   # ### ## ############ # ### #   ##  # #  ######## # ## ## #  ## #    ##  # #         ######    #  ##   # ###   ##    ###### #   ##  ### #
# ###     # ##  ## ## ### #   ##    #  # ## # ##   #      ##    ## #  ## #### ## ## ######  # ##  #### #### #####  ###### ##  ##  # ###  ## # #
#   # #####    ###  # # # # ########## # ##    # ### ######### ##  ## ## ## #    #     ######  # ### #  ##   ## # ## # #   ##  ## # # # ### # #
### # ##  ####   ## # #   #   # # ## # # ### #    ##  # ###    ### #  #  #  # # ## ###   ## ##     #   ##  # #  # ## #   ###  ##        # # # #
#        ## #  ###    ### ### # # #    #  #######  ##     ####   # ## ## ## # #### ##### #  ### #### #### ##### # ##   #   # ##  # ###### # # #
# #### ###  ## ###### #             ## # ## # #   ### ##### ### ##  #  # #     # #    #####   #    #       ## #    ## ### ##    ####          #
#####    ## ##   ##   ### # # ## ####    ##   ### # #  ## # # # ### ## # ### #     #### #####   ##   # ###### # ##### #####  # ###   ####### ##
### ## #### #  ######     ###  #########  ## ##   # # ##  # # #  #  #  # ##  ## ####     # #  ##### ## ## # #   ## #   # #  #### ## #### ######
#       ##  ## ## ##  ##########    #    ##   # #   #  # ## # ## ## ## # ## ######   ##### ## ###    # ##   # ###  # ### ## # ##         # ## #
#######  ## #   # #  ######  ###### ####  ## ###### # ## ## # #   # #       #  ##  #    ## ## # ## # ###### #  ### #   # ##      #########    #
#     ## ## ## ## #####   ## # ##   #    ##    ##      # #  # ### # ## ####   ### ### ####       ####### #  # ##     # # ## # ####     ##  ####
### #    ## #  ## ### ### ##    ### ####  # # ###### ### ##    ##   #     ### #   # #### # #####  # ## # ## #  ## ###### ## ### ## #######  ###
########  # # ##  # # # #  #### #    ### #### # ## #      ####  # #   ###########    # # # ######## ##    # # ##  ### ##     ##  #  ###    ## #
# ##     ##    # ##     # ##    ### ## # # #     # # ####### ## ##### ###   ###   #### #        #    #### # #  # ##   ## #####  ## ## #### ## #
#  ##### ## # ##  # ### # ##### ##  ##     ##### #       ##      ##   # ###   ###    # # ######## ####      # ##  # #### #   # ##       ##  # #
# ##     #  ##### ###   #  ## # #  ###### ###    # ############ #### ##  ### ##   ##        ### # ## #### #   ## ## ## # # ### ## ### ##### # #
#  ##### ##  # #  ##### # ##      ### # #   #### # # ## #####   # #   # ## #  ## ###### #####     ## #  ### #       ##       # ##   ####  # # #
# ####    ##   ## # ##    ###### ## # # # ####        #  ##   #   ###   ## # ###      #### ## #####    #### ###### ##  #######    #  # ## # # #
#  # ####  # ###  #  #### # ##             ##  # ## ### ### # ### #   #### # ##  # ##### # #   ## ### ###    #  ######     ### ####### ## #   #
# ##    ##   # ## ##  #   # ###### ##### #  #######     # ##### # ## ## #     ## ### ##  # # #### # #   ### ## ## # ## ##### # ### ##   # ## ##
# ##### #### # #   ## ###    ## ###### #### # # #   #####  # #  # #  ## ## #####  ##  ## # # ## # #   ### #  #    # #      #          ### ## ##
#  ###   ###   # ###  #   ## ##  ##     #   # # ### # # ## # ## # ## ## ##   ##  ####  # #    # # # ### # ##   #### ## ##### ## # #####       #
# ## ## ## ## ##  ### ### #   ##  ##### ### # # # #     ## # #  # ## ##  # #  ## ## # ## # #### # #  ## # #  # # #            ### ##  #### ## #
# ## ## #   #    ##     #####    ##   # # # # # # # ## ### # ## #  # #  ## ## #   # # ## #   ## # # ##  #   ## # # # # # ############  # # ####
# ## ## ### ####  ## ######   ## ####       #   # # #####  # #  ##     ##   #### ##   ## # #### # # ## ## ###### # ### ####  #  ## ## ## # # ##
#    ## ##  ## # ##  ###  ######   ### #### ## ## # # # ## # ## #### ######  ##   ###  # #  # #     #      # ###    ##  # # ## ### #  ##      #
# ##     ## ## #  # ##   ##      ### ####   ## ## #   # #        ##  # # #  ##  ### # ##   ## #####   ###### #   ##  # ##   #    # # ##  #### #
########  # ##   ## ####  ######   #      #         # # ####### ##  ##   ## ## ## # #    #      # # #      # ## ########  #   ####    ##   ####
### ## ## #    ###    ### ##     # ######### ## #######  ## ##   ##  ## ##  #         ####### ### # ######## #   # ## #  ## #   ##### #  #   ##
#      ## ### ## ## ### # ###### #  # ###    #  # ## ### ## ### #### ##  ##   ### # #    ## ####  #  ## ## #   #        ###### ## ##    ## #  #
## # #     #   # #   ## # # # ##### # #   # ###      # # #  # # ##   ## #### #### # # ## ##  ##  ## ###  #   #### ### ### ######   # # ########
#### #####   ###   # #  #   # # #     ### ### ### #### # ##      # ###  # ##    ############ ## ### # ##   #    ########  # ###### # #### # ###
# ##### #### ##  ###### # # # # #### #######    # # ##   ###### ##  ## ## ## ##### ##   ## # ## ##    #  ##### ###   # # ##  # # # #    #     #
# # #      #  ##  # # # ### #   ## #  # ## ####      ## ## ##   #  ##     #    ##   ## ##  # #   # #### ##  #### ## ##   ## ## # #   #### #####
#   ###### # ##  ## #    ##   ###  # ##      #######  # ##  ### # ##  ## ## ###### ##   ## # # ###    # #  ##    ##  # #### ## # ## ##        #
###           ##  # ### ##### # ##    ######         ##    ## #   ## ######   # ##  ## ### #    ## ####   ##  ## ### #  # # ## # #  ## ########
#### # # ## ###  ## # # # # # #  #### # #    ## #### #### ### ###    # ##   ###  ##  # # #   ##### #  # ###  #####     ##   ## # ##           #
#  ######## # ##  # # # # #   # ####  # ## #######    # # ##  # # #### ####   # ### ## # ## ###      ## ### ### #  ###### ###       ###########
## ## #     # ### # # # # ###    # ##    ##### # ## # # #  ## #   # ##  #   ### # # ## # ## # #### ###    # # # ##   ## #   ## #### ### # ##  #
#     ##### # # #   # # # # # # ##  #### ##       ### # # ##  ### #  # ## ###       ##   #  # ## #  #  #### #   ## ####   ###   ##### #      ##
##### ##          #         ###    ### # ### ####  #      ###  ## # ## ##  #  # # ##### ## ## #  # ## ## #    ###   ##  ### ###    ## # ### ###
#     ###### # # ## # #####  ### # ##      ###  ## ######  ## ##          ## ########      #  ##       # # #### ###  ## #    ## ####      ### #
#### ##      #####  # ###   ## ###  ### #######    ## ##  ###  # # ## #####    # ## #### ### ##  ####### #   ## # ##      # ###  ##  ## #  ## #
#    ## # # ### ####### ###    ##  ###   ##  ### #  # #  ##   ######   ## # #### ## # #       ## # # # #   ###  # ### ##### # # ##  ##  ####  #
## #  #######     ###   # ## ##### # # #  ##   #### # ##  ###  ## #  ####        ##   # #### ##          ### ## # #     ##### # ## ########  ##
#####  # # ###### # ### # ##  ##     #### ####   ##   ### # # ### ## ## # ######  ### #    ##### ## # #### # #  # # ##### ##         # #  ##  #
# #   ## #  ###            # #### ## ###  # ### ##  #  ##   # # # ##           #####    # #### #  ###          ## # #   #    # #######   ### ##
# ###  # ## # ## #########     ## #  # ##    #     ### ## #   # # ###### ### ####  ## ######     #### ## ## ## ##     ### ####    ##   # # #  #
#   ##   ## # #  ####  # # #########    # ##   # ###      ## ##    # # # ###### ## ## ## ##  # #    #### #######  # # # #    # ##### #####   ##
# ##### ##  # ####  ## # # #######   # ##################### #  # ## # #    ##  ## #      ## # # # ##  ### ## ### ###     ######   # # ##  #  #
# ###    ##    ##  ##          ##  ###  ##   ##       ## ##  #### ##     ###### #    ### ##  # ###  ##  #   # #    #### ###   ## ### #    ## ##
#   ## #  #### ## ###### ##### ####### #####  # ### #     ##  ##   #####  ##  # # ##  ##### ####### #  ## ### # ####  #   ## ### ###   ########
# #    ##      ##  # #    #  ### ##    # # # ########### ##  ##  # # # # ####   # ##### #     ##  ####        # #### #### ##         #   # ## #
######  ## ###  ## # ####   ###  ### #   #    ##  ## ### ### ### ###      ##### # # # #   # #  ## ##   # # ##          ##    ###########    # #
## # # ####### ##       # ### ##   ##### ## ##### #  #        #   ## ####  # ##         # # ##     ### ####### # ### # #  ##  #      ##### ## #
#      ## #       ## ##   # # ## ###         # #  ## ######## # ###    ### # #  ###### ####  # # # # # ###  #### ######## ###   ## #     #    #
### ## #    ## ## #  ## #     ##   ### #### ## ## #  ### ##   #   ## ### ### ## #  ###  ### ########   # ## #  #      ##   ## ###### ###### # #
#    #### # #  #### ##  ##### ## ### ####    # #    ##   #### # ####  ##  ## ## # ## #### #     # #  #        ### ##########    # #      ######
## # #  ######## ###########      ## ## #### #   ## #### #    # ## ##  # ##  #            ## # ## # #########   #     #    ###### # # ##   # ##
####### ## ####            ###### ## ## # #  ## ###  #   ## #   ##    ##  ##   # # # ############   # # ### ###### ##   ####      # #  # #    #
# # #   #   # ###### ### #   #       ##     ##### ## ### ###### ##### ## ### ######### ## # ### # #             ##### # #    # ########### # ##
# # ###   #   #### ###   # # ###### #### ##  ##   #        ##    # ##          #####   ##    #    # # ## # ## ### # ###### ##### # # ## ## #  #
# # #########    # ######### # # ## ## #####  ### ####### ##### ##  ## ######### # ###    #### # ## # ## #######       ##     ##         # # ##
#   # #  # ### #   # # #  #         #  ###### ##  ## # ##  ##    # ###         # #  ## ##### # ########   ## #   #######  # ###  ### ## ## #  #
# #   ## # # ##### # # ## ######### # ## ##    # ##    ### ### #    #  ### # # #   ###              ########   ###  ##   ####   ##    # ##### #
# # #         # #       # ## ####         #### #  ### ## # # ######   #### ### # ### # ############## # #    ### ##  ## ##  ## ########## # ###
# ### # # # #     ## ##         ###### #### ##   ## #  # # # ## # # #    #   # #   #     ## ###  # #  # # ####    # ### ## ##      ######     #
# ##  ######## # ########## # #         ##     #    ##       ##     ## ######### ### # #  #   # ## # ## # ##   ##     #       ######  #   # ###
# ## ### # #   #### # #  ####### ###### ## ###### #    #### ###### ######   # #  # # ###### ###    #      #  ########## #######    ## # ###   #
# ####       ####       ## # # ##### ## #######   ## # #    ##      # # # ### ##      # ##  # # #### ###### #### # ## #   ##    ##### #   ## ##
#  ####### # ##   # # #         ##    # # #   #############  ##### ## # #   # #  ###### #  ##           ###      # #  # ###  # ## # #   # #####
# ##       #### ####### ## ####  ####   # ### # ### #  ## ##  # #         # # ## # ###  # #### ###### ### # ###### ## # # # ##### #   #####   #
###  #######    ##   #  #  #  # ### ###   ##          ##  ### #   ## ## #####  #       ##    #    ##### # # # # ## ## #         # # #### #  ###
#### ###   ## # ####   ######    #   ### ############    ## # ## ######### ###   # ###### # ## #### ###          #      # # ###            ####
# #### ## ##  ### #### # ##### #   #  #    ## #### ##### #          # ###  # # ###   ## # ###           ### ## #   # # ## ####  ### ########  #
# # #      #####    ####   # #### ###   ##          ## # ###### ##### # ## #     # #       #  # # #### ####  # ## ## # ##  # ##   #        # ##
#   ##### ##   ####      #        #   # ## ##### ## ## # ## # #            ## ###### #####   ## #    #    # ##  #  # # ##### ### ##### # ###  #
# # ##     ### #  ###### ### ### ############ ##### #       # # ##### #######     ##    ####  ##### ## ## #### #######         ###########   ##
# #  ##### # # # ##      ##  ###### ## # ##    ## # ####### # #  # ###### ##  ####### #   ###     ###  ##### ### #   ## # ## #### #   # ## ####
#### # ##    #   ###### ##  ## ## #      #####    # #       # ##   # ## # #  ##  # ######## ############ #         ###### ######    #         #
###     #### ###   ######  ##   # ######   #   ##   ####### # #  ### ## #   ##  ##   # ## #  # # ## # #    ## ###### # ##   ## ## ######### ###
# #####      # ### #  ##  ##  #   ## #####   ######   ### #   # ###  #    ###  ### ###  # # ## #      # #####           ###     #     # ##### #
# # #   ## #   #     #### #  ####          # ##     #       #     ##   ##     ## # ####          ######     ## ## ### # #### ## # #####       #
#     ###### #   ### ######### ### ##### # # ## # # # ### # #### ##### #########   # #  # ## # #        #########   # #   ## #### # ### #######
## ## #   #  ## ####  ## # ##      ##  ### ######## ### #####     # #    # # #   #     ####  # # ##### ##       ## #### ###### #          # # #
#  #  # #   ##  #    ##       ######## ### ## ## #####        # #     ##       #######   #######     # #  # ## ### # ##    ##    ########     #
## ## # ## #### ## #    ## ## ##           #           # # ## # ## ##  # # # #       # #       # ## ##   ## ##   #   ## ##    ##        # # # #
############################################################################################################################################# #
