# ########################################################################################
# #    # # # # ##     ## ##     #   #  ## # ## # ## #   #     # ##   ## # # # ####  ## # #
#   ##     #   #### ###  ###### ### # ##       # ## ###   ### #  ### ## # #    ##  ###   #
# ######## # ###    # ##  # ##  # # #  ####### #  # ##  # ### # ## # ##   # ######   ### #
#### # # #    ### #   ### #  ## # # ## ##      # ## ####### # # #     ### # # ##   ###   #
###      ### ## #####  ## ##      # #   ### ## # #   # ##     # ##### # #      ###  #### #
#   # ## ### ##  # ## ### ####### # ## ## ###  # ###    # # #       #   ### #### # ##    #
#######      ### #      # # # #   # ##     ###   ##  ############## # ####   ##  #  ## ###
#    ## # ##   # # # ##   # # ###   ######   ### ###  # ## #  ### #      ###  ##   ###   #
## #    ##### ## ### #### # # # ## ## #  ### ##   ## ## ## ## #   ### ## ##  ##### # # ###
#### # ####   #   ####        #     # # ## #  ###  # ## ##    ###      ##### # ### #   # #
# ####### ### # #  ########## ##### # # ## ## # # ## ##  #### ##### #####      # #   ### #
#   #     # # #### # ##           #   #  # #          ## ## #       # # ##### ## ## ## # #
### #####      #      ########### ### # ## ## #### ####  ## ####### #    # ##            #
##   #  ###### ##### ###  ## #### #        #####   ## ## ##  ###    # ####  ###### #######
#  # ##      #  #    # ## ## #    ########  ##   # ##  # #  ## ####    # ## ## # # #     #
####  ## ### ## ####   ## ## #### ## # # ##  #####  ##   # ##  #  ####   ## ## # # # #####
# ### ####         ### ##    # ##           ## ##  ##### #  ## # ### # ###  ##   # # #   #
#     # ########## ##   ####    ### #######     ## ##      ##  # #       ## ####     # ###
##### # # #      # #### # #### ## ####  ##  ###  # ###### ####   #### #####   ##### ##   #
#         #### #     ## # # ## ## ##   ##  ## ## # # # ##  # ###  #       ###  ##    ## ##
###### ##   ## # ### #    #     #  ### #  ##           ## ## # ## ### #####   ##### ##   #
#    ######  ####### ####   ### # ## # ####  # ### ###    ##      ##      # #  # ##  ### #
### ##  #### ## #      ######           ##  #####  ##  ##  ###### ### ######## # #  ##   #
#    ## #     #   #### # # ##### ###### ##### #   ######## # ## # # # #   ## # # ##  ### #
### ### ##### ## ##        # # ##### #   # #    # ##         ## # # #   #### #   #  ###  #
#   ##   ## # #  ## ###### #         ### # #### ############    # # # ####   ###   ## ## #
### ### ##    # ##  ###    ### #####     #  #########     ### #   # # #  ###  ### ##  ## #
#   # # ##### ####### #### # ###   ## ## # ## ### ##  # #   ##### # #   ## # ##   ###    #
# #      # #  ## # #         #####  ###  # #       ###### #  # ##     ###  #  ### # #### #
###### #   ## ## #   # # # # # ##  ##### # ## # ##  ## #  ##      # #   ##   ## # # ##   #
#      # #     # ########### # ### ## #     ####### ##   #### ## ## ## ##### #    # #  ###
### # ###### # # # ##   # #  # #   #    ###   ##    ### ## ###########  ##   ####   ##   #
# # #   ##   #      ###   ## # ### ## ### ## ##  ##  ##### # ##        ##### #  ###    # #
#   # ###### # ## #  #### #    # # ####       ##### ## #   #  ### ## #  # ## # ## ## #####
# # ### ## ### #  ##        ## # #   ########  ##    # ### # ## ####### #    # #  #      #
# #####    ##  ###### #### ##      ###      ##  #### # ##        ## #   #### # ## ## #####
##### #### #####      ###  ### # # # ## # #    ## #     ## ## ## ## # #        ##  #     #
#      ##     ##### # #   ##   ### # #### # ##  # ### #########  ## # ## # ### ###   # # #
### ## ## ### # # ####### #### ##       #######   ##  #  ### ## ### ###  # #       #######
# ###   ###       ## #    # ##  ##### ########### ## ## ##      ##   ### ##### ###    # ##
#  ####  ####### ##  ######    ######  ## # ####     #  ### ### ### ## ###     #   ##    #
# ##  ## # ## ##  ## ## ##  # ##    # ###    ##  # #   ## ###        #   ######### #######
#  ##          ## #     #  ######## # #   ##    ######     ## ## ### ## ## #          ## #
# ##  ##### ##    ## ##   ## #  ##      #### # ##      ## ##  ## #      ##   # ### ##    #
#  # ##   ###### ####### ### ##    ### ####  ###########     ##### # ##    ### ##   # ## #
# ####### ## #    # #  ### # ## ########  ##### # #      ## ## ##  # ### ####  ## # # ## #
# #  ## # ## ### ##   ##        #    #### # ##      # ## #  #     ####   #    ##  #####  #
#   ##     # # # #### #### ####### #   #       ## # ####### # ###    ####### ####  #  ## #
## #### ## #     # #   # #####   # ###   ## ## ## # #       # #### # #       ## ##   ##  #
#   # #### ##### # ### # ##  ### ####### ##  # #  # ## ## # # #    # ## ####     # ##### #
###   ##                  # ##    ## ##   ## # # ## ######################### ## #   ##  #
#   #    # # # # ## # ### # ##### ##    # #  # # ## #               # #        # ## #### #
# #### ################   # # # # #  ## # ## # # #### # ## # ### ##     # # # ####  ##   #
#####    ## # # # ## #### # # # #   ### # ## # ###    # ######   ## # # # # #    # ##### #
#   ####### # # #                 #   # ###  # #   # #### # ### ##  # # ###### # #  ##   #
# #  ##  #    # ######## # # # # ### ##   ## ####### ##         ## ####     ## # ##  ## ##
#### ### #### # # # #    ### ### ##   # # #  #  ###  ## ## ## # ####    # #  # # #  ######
## # # #            # ##  ## ##  ## ########### # # ########  # #    # ## ######### #    #
#      ######### ##   ## ####### ##  ##  # ## #      ##      ## ## # # ##    ##   #   ## #
#### #            ### ##  ##     ###  ##        # # ####### ##  #  # ###  # #####   #### #
#    ### # ## # ####   ## ## ## ## # ##  ### ## # ### # ##  ## #######   ## ## #  #  # ###
## # #######  #####  # #  ##  #### #  ## ##########   #    ##  #  ###### ##    ## ##    ##
#  ### #     ##     #####  ## ##     ##  # ##       #   ##  ## ##  #   # ### #### #  ##  #
#####    ## #### ##   ##  ### ### ## ## ## ### # ## # # #  ##   ##   #     # #    ## #####
###   ## #  ## #  ## ##  ##     #  # #  #      ######## ##  ## ####### # # #### # #      #
# ###  # # ##    ##   ## ## # # # ######## ###  ##      ## ### #       # #   ## # ### ####
#     ## #  ## #  ## ##  ## # # ### # ## ###   ##  ## # ##   # # ### # # ## ##  # #      #
### #  # # ######  # ## ####### ##           #  ## #  # ## # # ###   # ###  #  ##### # # #
#   # ## ####     ## ##  # #    #  ######### # ###### # ## # # #   # #   ##### ##    #####
### ########  # #  #######   ## ## #         # ##     # #### ##### ### ###      ## #     #
#   ##  ## ## # ##     ##########  ## # # ## # #  # # #   ##### #  #     ## #####  # # ###
# #  ##       # ## # ###  ##   ## ####### #  # # #### ## ##       ## # #  # #     ## #  ##
######### ## ####  #   ##    #      ####  ## # #    ######### # # #### ####### # ######  #
#         #     ## #####  ## # ## ### #  ### #### ###  #      # # #      ##    # ##     ##
## ###### # # ####  ##   ### # ## #     ##     ##   ##   # ## # # # ## ###  ## # ## # #  #
#  #      # #  ##  ##  # ##  ####### # #### # ### ##### ## ## ##### #    ##  # #### ### ##
###### ## ### ####  ## ##### ##      ###    ###    # #  ##  ###     ## ##### # ## # #    #
### ####  ##  #    ###  ##   ## ## #  ## ##   # ####   ##  ##   # # #     ## ###    ### ##
#        #### ## #   ##  ### ## #### ##  #  # # #    #  ##  ### # # ## #####  ##### ##   #
# ### # ##  # ## # #  # ##   ## # #  ## ### ###### # # ######   # # #      ##  ##   #  # #
##### #####    ### ######  # ## #   ########## ##  # #  # ##### ### ## # #  ## #  ###### #
### #  ##   # ##        ## # #  ## ##    # ##     ## ## # # ##    # ## # ## ## ## #      #
#     #### ## ## # # ##### # ##  ##### #      # #  ###  #      # ## ## ###  ## ## ##### ##
### #   ## #   # # ###     # ### ## ##### # # # # ##### ## # # # ## ##   ## ## #  #     ##
### # ######## ###   #######  ## #  # # ### # # #     ###  # ### #  ## # ## ###########  #
#   #### ###     # #  ####### #  ## # # ##  # # ## ####### # ##  ## ## #  ### ##        ##
### #        # # # # ##    #######         #### #     # #  #  ##  # #  # ###     ## # #  #
#   ### #### ### ###  ## # # ## ## ## # # ####  # # #   ## ## ## ## # #### ##### #### # ##
#####   ##    ## #   #####         #### ### #  ## # ## ##  ## #   # #  ### ##       ###  #
#     #  ### ##  # # #  ## ## ## # #     ##   ##  # ##  ## ## # # # # ##      ## ####   ##
# # # # ##    ## ### ##    #  ## #### ##  ## ##  ##  ## #  #  # ### ###  # # #####    #  #
# ### #  ### #####   ### #### ## #    ## ##  ## ##  ##  ## ####   ######## #     #### ## #
# #   # #### #   ### #   #    ## ## # ##  ##  # ## ####  ####   ####       ## ####    #  #
# ## ## ##     ###   ### ## #  ###### ####### # ## #    ##    #    # ### # #    ##### ## #
#### #   ### #   ############ ###         # # # ## ### ##### ## # ## #   ### # ##     ## #
#    ## #### # ####           # ## # # # ##   #  ###   #      # #  # ### ##  ######## ## #
# ##  # ##   # #    ## # # # ##  ### # #  ## ###  #### ### ## ### ###### ### #         # #
# #  ##  # # # # # ##  # # #  ##     # # ##  ##  ##    ##  ##   # #      #   ## ## ## ## #
######################################################################################## #
