# ###################################################################################################################################################################
#  # ##    ## # #  # ## ## ##     ## # # ##   ##    # ##   ## #  #   ## # # # ##   # # #     #   ## # #  ## # # # ##   # ##   ####    # # # # ##   # # # # #    ##  #
##    ## #  #   ## # #   #  #####  # # #  ### ##### # #  #### ## # #### # # #  # #   # # ##### ###  # # ##         ### # ####  ##  ####       ## ###       # ###### #
#  ####### ## ###    ### # ### ###     # ## #  # #      ## #  #     ##      # ###### #       # # ## # # ## #########      ##  ####   #  # #####  ### ## #### # # ## #
## # ####  ##   #### # #    #    ##### # ## # ## ### ##  # ## ##### ### # #    ## ##   # # ### # #  # #  #     ### ##### ##  ## ## ### ##### ## ## #### # ## # # #  #
## #  ##  #### ## ##   #### ### ####          ## # #### ## #   # #    ##### ## #     #######   # ##   ##   ##### # # # # ## ##  ## # #   # #    #   # #            ##
#  # ##  ## ## ## ####   ##  ## ## # # ######    # ## # ##   ### ## #### #   ### ### ######### # ####    ####  # # # # # ##  ## ## # # ### #### # ### ## ##### # ####
## # ### ##  # #   # ###  ## #  ## ############ ## ##   #### ##        # ## ######     # # # # # # ##### #  ## #         ## ##  ##   # # # ##         ##   # ########
#     ## ### # ###    ### #  # ##   # #       #  # ####  ##   ###### # #     # ##  ### # # # # # # # ##    ##  #### ## ####  # #####        ## ######### ###    ## ##
## ##  #  ## # # ## # # # ## # ## ###   ## ##   ## # ### ## ####  ## ###### ## ## ####   #   # #     ##### ## ### ###   ##  ## # # # ########  #   ### #  #  ####   #
#  ### # ##  # # ## ###   ## # ##  ####### #  #  # # # #     # ## ##  # # # ##  ###    ### ### #### ## ##   # # #  ### ##  ### # #      ## ###   ### # # ## ### ## ##
####      ##     #   #### #    ## ## # #   # ###     # ## # ## ## #  ## # # ###  #  ## # # # #   ## ## ####       ##    ## ##  # # ######  #   #   # #        #  #  #
###  # # ####### # ###  # ### ##  ##   ### #  ### ## #  ### ## #  # ##        ## # ##### # #   # #  ## # #  # ######### #   ##       ## ##   # # ###   ### #### ## ##
#   ## # # ##    # # ##       ## #### ## ### ## ###  ##  ## #  ## #  ####### ###      ##   # ###### #      #### # # # # # ###  ########    #######   ### ### ##     #
########   ### #      #######    ##    #  ####   ### #  ### ## ## # ##  ###  # # #########      # # ## ### # #    # # #     ## ## ### # ##### #  ## ###   #  ## #####
#  # ##  #     ## # ### #   ####  #### ##  ##  #   # ## ##  #  ## #    ## ##   # ##  # # #### ###   #### # # #### # # ## #####    # # #   ##    ##    ## ## ##   ## #
## # #  ########  # ##  ## ## #  ###   #  ### #### # ## ### # ### # ####  #  #      ##   # ##  #### # #  # # ## #   # ##   ##  #### # # ##### ##### ###  ## ## #    #
#  # #####    #####  ##     # ##   ### ## # #####     # # # # ##  # ## ## #### #########   ###  ##    ##     ## ### #  # ###  #####       ##   # #  #### ##    # ## #
## # # # ## #  # #  ### # #      # #   ## #  # #  ### # # #    ##    # #   ###  ## # ##  ### # ######  # ### ##  #  ##     ## #   ## ######  ### ##    # #  # ##  # #
#  #      ####   # ## ###### ## ###### ## ## # #### # # # #### #  #### ## ## ##  # # ###  ## #  # ##  #### #  ##   ##  ## ##    #### # #  ## #   ## #### # ##########
##   ## ###  ### # ##  ##  # #    ##   ## #    # #    # # #    # ###   ## ## #  ## # # # ##    ## ## ## #  # ### ##### ####### ## #  # # ### # ####   ##     # ###  #
### ##    ## #      # #### #### ###### ## ####   ####   # # ## #   ### ##  # # ###   # #    ##### ## ## ## # ##  ## #    ## ##    # ## # # #    ##  ###### ### # # ##
# ###### ### ###### #  ##  ## # ###    #    ### ## #### # ####   ### # #  ## #   ###   # #####    ## #   #    ##    ## ###  #  # ##      # # ##### ## # #   ##   #  #
#  #     ##           ####    #   #### ### ## #  # #    #  # ## ##   # ##      ### ### # #   ### ##  # # # ##### ## #    ##   ####### #### #  ###   # #   #  # ### ##
## ### #  ## # ## ### ####### ## ## #  # #    ##     ##   ##     ###   ##### #  ## ##    # ###    ## ###   ### # ####### #  # # #   #  ### # ## ## ##   ####   ##   #
#  ###### #########    ## ### ## ## ##     # ############  ## # ###### #  ##### #  #####     # ##     ####   #   # ## #  # #### # #   ##         # ## ##########  ###
# ## ####   ##    #### ## # # #        ### ### #  #   ### #####  # #   # ## ##  # ## ##  # #####  ##### #### ### # #    ##   ## #####  ## ######## #  ##  # ##   ## #
#  # # #  #  ## #### #      # ##### ######  ## ## ### # # ## ## ## ### #  # ###      ### ### ##  ##  #  #  # ##    #### ## ###   # #  ##    ## ### ##  ##      ###  #
# ## #   ## ##   ##    ## #   ## ######    ##                 # ## ##  # ## # # ###### #  ## ## #### ## ## # ### #  ##       ## ## ## #  ##      # ## ##  # # #### ##
#  # ### #   ###    # ####### #    ## #### ####### # ##### ####    ###   ##      # # # ## #      ##     ## # # ####  ## ####### ##      ###### ###  # #  ## # ##    #
##   # #### ##   ## # #  ## # # ####  ## # # ##  #####     # ### ### ###  ###### # # # ## # ########### #    #  ##  ##    ## #  ###### ##   ###### ##   ##  ##### # #
#### # ##   ####### ####        ## ##        ### ##  #### ##  ##  ##  ### #        #   ## # # #  # # ## # #### ##  #### #### ##  # ###    ### ##   ## #####     ### #
#      #### # ### #### # # ### ##   ##### ##  ## ## ## #   ##  # #### # # # # #### # #### # # # ##   #     ##   # ##     ##  ## ##   # ####    ###  #     ########  #
######   ##        ##  ####### ## ###   ###  ##  ## ##   # ## ## ## # # # ##### ## #  # #   #    ### ### ###### # ## ###  ##  #  ###        #### # ## ########   ## #
#  #####    ## #####  ### #     # # ###  ###  ## ##  ### ###  #   # # # # ## #  ## ##     ### #### # ##   # # #   ## # ######   ## ### ###### ##   ## # ##   ## ##  #
##       ##### # # ## ##    ###     # ## #   ##  #  ##    #  ## ### # #    # ##    #  ######   ##     ### # # # # #     ### ## ##  #      ##   ## ###    ## ##  #  ##
#  # ### ##      # ##    ## #   ### # ## ###  ##   ###### ## ##  ## # # ##   ##### # ###     ####### ##       ### # ###   # ##  ##   ####### ###  # # #####  ## ##  #
# ############## #  ## ####### #### # #   ###  ###  ##       ## ##    ######  ##   # # # ##### ##     ### ####### #   ##### #  ##  ######  # # ##         ## ## ## ##
###    ## #        #####  ## # #        ###   ## ## ########  #  ## ####  ### ####        ##    ## ## ##   # ##   # ###   # ## ###      ## #    ### #######  #  ##  #
##  ## #  ########   #### #    # ###### # ### #   # # ##  ## ## ###  ##  ##        ########## #  ###   ## ##  # #   # ## ##        ######  # #### #     # ## # ### ##
#  ### ## ##   ##  ###  # # ######      #     ### #    ##     #   ##  ##  ## ##### ## # ### ####  #  #### ## ###### # #   # ## ###   ## ##          ### # ## # # # ##
# ##       # # ### # ##   ########## ## ##### #   ### ###### ## ###  ### ######              # ## # ##        ## #      ######## ## ##   # ########  #### ## # #    #
# ######## # #        ### ##   # ###### # # # ### # # # #    ##  ###  #    ## #### ###########    # #  ######### ### # ## ##  #  #   ## ##       ###  ##   # #   ## #
# #    # # ######## #      ### # # #                    ####    ## ## # # ##  ## # #      #  #### #   ## ## ##   # # ####  ## ## ### #  ## #### ## ## #  ###   #  # #
#### #     ## ##    ## # #         ######### # ###### ###  ## # #   # # #### ##      ###### ##      #### ##  ### # #  # # ### ## ##  ##       # #   ####     # # ## #
## ##### #       ############### ###   ## ######       ###  # #### ## #  ##   # ## ### # ## ####### # #     ##     # ## # ##  ##  ## ## ####### ###  # # ############
#   ## ############  #####         ###    # # ######## # ## #  ##   # # ##### ###         #  ## ##  #   ######### ##  # # ## #### #  ##  #    # #   ##       ## ##  #
## ##   #  # # ## ## # # ######### # ####   # #          ## # ##  ###    # ## ##  ##### ### ##  ###   ### ###      ##   # ##  # # ## ## ## ####### ##  ########  # ##
#   ### ##   #  # #  # # #   # #   # #    #   ### # #### ## # ### # # ####    ###  #  ### # ### # # # # # # ##### ##  ###  ## # # #  ## ##    ##    ## ## ## #  ## ##
# #      ### ##   ##   # ### # ###     ## ### # ##### #   # #  ##     #  # ##   ##   ###  #  #  # # ### #    ## #  ## ##  ###     ##       # ###### #      # # ##   #
####### ##    ###  ### # #         # # #  #   #  # #    #     ###### ## ###### ### #   ## ## # ## #  #  # ## #  ##       ## # ### ## # ######## # #   # # ##    # ###
#    ##  #### # # ###  # ######### ########## ## # # ##### ##  ## #  #   ## ## # # ######      ## ## ## #  ####  # #######    # ######     ## # # # ########## ##   #
#### ### # #      # ## # # #   ###### ## ####    # ##### #####  #   ## ####    # # #### ##### ##  ##    ##  # ## #    #  ####    # ##  # ###  # #        # # #    ###
###          ####   #  # # ### # ##       # ####   #     ##  ## ### ## #  ### ##      #  ##    ##  ## # ## ## ##   #### ## #  # ## ### ###### # # ######## #   #### #
# ###### ## ### ### ## # # ##  #  #######        #   # #  ##    ##       ##   ### ##### #### #    ##### #   #  ###  ### #  # ####   ##  #  ##         # ## ## ## #  #
# #    # ## #    #     # #  ## ##   #  #### ## # # # # ##    ##    ########## #      ## # ####### ## #  ###   ##   ##   ##     #  #### ## #### ### ####  # ## ## # ##
# #### #### ####   ###   # ### #  #   ## #   ### #####  ## #######  ##    ##    # # ###   # # # #    # ##   ######  # ###  ##### ####   # # ##  ####  ##       # #  #
#  ##   # ### ### ###### # ##  #### # ## ########## #####  #       ##  ###### ########  ### #   #### #  ## ##  # ##     ##  ## # ## ## ## # ### # #  ### ####### # ##
## #### # ##      ##     # #  ## #### ##  ## # ###    # ###### # #  # ##  ##  ## # # ##  ## ###  ##  # ###  ## #  # ###### ##    ## ##  # # #       ## #    ##      #
#          # # ######### # ## ## # #   ##      #   ## # # # #######      #### #    # ## ##  # ##  ## # # ##  # ## #    ##   ## ####  ## # # # ##### ## # ##### ######
## # #### #######  #     #  # #  # # ##### ### # # #  #   # # #     ## ### #    #### ##  ## #  ## ## # # ## ##  # # ###### ### #  ##  # # #    ## ####     ##   # # #
#######    ##   ## ##### ## # ##     ##  ####  ###### ### #   ########  ## # ####  # ## ##  # ##       # ##  ## # #   ## #   # # #### #     ####   ##  ###### ### # #
### #   ##  ###  # #        # ### ## #  ### ##  ##    # # # ##### ## ##  # # # ### # ## ###   ######## # ## ### # # ###  # ### #   ## # ## ##  ## #### # ##   ##  # #
##    # ### # ## # ## #####   # #### ##  #   # ######        ##   #   ##   # # # # #    # ## ##  ##          #      # ## #   # # ###  #  #  ## ## # #     ###  # ## #
#  # ####        # ## ### # ###  #   ###   # # #### ########  # # # #  # ### #     # ####     ##  ## # # ###   ### ## #    ### # # ##   ######  #   # ###   ##   #  #
######    ## # # # #### #     ## ###  ######    ##        #  #### #### # ##  ### ###    ##### ### ########### ######  # #####  # # ## ### ## ##   ### #######  #   ##
# #  ####  ##### # # #  ##### ##  #  ##      ##  ######## ## # #  ##      # ##     # ######    #   ## # ## #       ##    #  # ## # ##     ## #  ###     ### ## ## ###
# # ##    ##     # # ## ##     ## ##  ##########  ###     ## # ##  ######   ##### ##  # # #### ## ###      ## ########## # ## ##   #  # #### # ###### ### #  # ######
# # ## # #######   #     #### ##   ##  ##  ### ## # ##### #     ##  ### # ### # # #  ##   ## # ## # ###### #      # #  #       ## ## #### #  #  # # # # # # ##   # ##
# #  ####### ##  #   ### #     ###    ##  ##      # # #     # #    ##      ## # #   ### ###       #  ###   # ###### ## ## # ####  ## # ## # ## ## # # # # #    ###  #
# ##  # # #     ######     ## ## ####  ## #######     # ## ####### ###### ##  # # ### #   #### # ## ## ### # ##  ## ##    ### ### #    #  #  #  # # # # #   ####   ##
#  # ## # ####### # #### ###      # # ###  #      ## ####### # #    ### # ### # # ###   #### ### #  ## # #      ##  #####  #  # # # #### ## ## ##         # ## ## ###
##      # ## # #    # #####  # ##     # ## ### #####  ##  ##   ####     #  ##     # ###  # #  ## ##      ## #######   ### ## ## # #      #   # ## ## ## ### ##  #   #
#  ### ## #    ####         ######### # ## # ##### ##  ## #  #   ###### ## ## ## ## ##  ## ## #   ## ## ##      ##  ###       # # # ### ## ###     ##########  ## ###
## #    # #### ###### #### ## # #     #    # ##       ### ## ###  #   #  # ## #      ## ##  # ### ## #     ## # ###   #### #### # # # ####  ## ###  ## ## ##  ##    #
##### #   # ##      ###  ####   ##### # ####  ##### ####   ### ## ### ## #  #### # ###   ##    ##  ##### ######## # ### ##   ##        #   ###  ### #   # ## ### ####
# # ##### #  ###### #### ## ### ####     # # ## ###  # ### ##  ## ##  #  ##  ##  ### ## #### ##### ## ##     # #     ##    ####### ##### ### # ## #####    # # #    #
#   ## ##   ## # #                   # #   # ## # # ##      ##     ## ##  ## ###  ##  #  ##  # #   ##    # #   ### #######   # ##  #      #     # ###   ## #     ####
### ##    #  # # ####### # ############## ##    # # ###### #### ##    ### ##  ## #### # ##  ## ###  ## ###### ## #  # ##   ###  ## # ###### ###     ### #### #####  #
# # ########      ## # ######### ## # #    ## #   # # # #   # ####### # # #  ###  # #    ##  # #### ##  # # #### # ## ####   ##               # ##### #   ##       ##
#    ##   ####### #     ##            ### ####### # # # ### #  ##         ## #   ## ## ##### # # #  ## ## #  ##        ##  #### ### # ###### #######  # #### ########
#### ### ## ##    #####  ### # # ####      # #           ## # ##  ####### ##   ###  #   ## # #   ##         ### ##### ##  ### #  ## #  #   ### ##  ## # #       ##  #
#              ##  # ###   ############ # ## ###########  #    ######     #  ### ## ## ### #   # #  ## # #### ####     ##       ######## #####  ## ## #   ## ####  ##
# # # #### ## ####     ## ##    #       #    ## ###  # ## #### ####   ### ##  ##    ##   # # ########### # ##  # ##### ## #### ## ## ###  ## ##  # #  # #######   ###
# ############# ### ##    #####   ## ####### #    ##      ## # #    # #    # ##  # ##### #      ##   ##     # ##  ## #       ###     # # ##   # ## ##    #  ##  ### #
#### ##  ### ## # # ### #  ## ######## ## #    ## ##### ###  # #### # ####    # ## # # # # ######  ###### ### ## ##  ## ######### #### # ## ### #     ## # ##  ## # #
###   ## #    # # ### ### ##     # ##       # ##         ### # #  ##### #### ##### #   #   # ## ##  ### # ##  ##  ## ##  #     ## # #     # # # # ########    ### # #
# ### ##   ##      #   #   ##### # #  # ############### ##     ## ##    # #   ## # ### ###   ## ###  #    ## ####  # #  ## ######     ##### # #         ## # ##   # #
#  #  #  ##### ### ### ### ## #    ## ###  # ##   ##     #### ##  ##### # ### ## #  ## # # ###   ### ## #### ## ## # ##     ### # ##### ##  #   ########## #### #   #
## ## ## ##    #       # #  # #### #######      #  ### ### ## ###   ##        ## # ##  # #   # ### # #   ##  #   #   ## ###   #          ##   ### # ##     ## #### ##
#     ## #  ##### # ## # ##         ### #  # ## ## #    ##  # # ### #  ###### #  #  ## # ###    ##     #  ## ### # ####  ###### ###### # #  # ###    ### ####  ##   #
## ##  ########   ###     # # #### ## # #### ##### #### ###      #    ##    # ##   ##    ##  ######## #####         # # ## ## # # # #### ## ### # ####     #  ### ###
###### ##  ## ### #######   # #       #   #### ##       # ###### ##########    ###  ### ####     ## #  ## ###### #### # #  #        # ####           ### ### ##     #
#         ##   #  #  #    # ######### ## ## #   ### ###   # # #  # # # ###  #######  ##  ##  #####    ###  # # #  # # # # ## ## # #    ##  ############         # # #
######### #### ## ##   ## # #         ## ## ## ##   #   #     ## # #     ## # ## ## ####  ## # # ## # # ## # # # ## # # # #   ##### ###### ## #         # ######### #
# ### # #  #   ###### ##  # # #######    ## ## #  # ## ### ##        # #       # #   ##  ##    # ## # # ## # # # ##         #  #  ### # #       ### # # ######## ####
# #     ## ### # #    ## #######      ##         ## #   ## ###### # ######## #   # ###  ##  ####  ### # #      #  ## ##### ## ## ###  # # ### #############       ###
# ## ##          ### ##   ##   ##### ##### # ## ##### #  ###      ### # ########    ###  # ## ## ###    ## # #   ##   ####  ###    ##      ##     #######   ### #   #
# ####  ######## ##   ######## # # ### #   # #  # ### ######## ## ### #     # ##### # ## # ##  # # #### #  ### # #  ###  ##   ## ###  ####  ## ##   # # # ######### #
# # ######          #####  # # # #       # # #### # #### #  ####  #   #####           ## #  # ## # ## # ## ######## # # #### ##  # # ##  # ##########             ###
#     ##   # ## # # ### ##         # # # ### #### # ## # ## # ####### ## ### # # # ##  # ##   #  # ## # #    ## # #        #### ##      ##### #  # ## #### # ########
# ###    ############      ##### # ###########         # #        ##     # ### #######      ### ## ## # # ##### # # #########      ###### # # # ## ##    ###### # # #
##### # ### ## # # ###### ##     # ##      ##  ##### #   ####### ##  # #    ######     ####         # #    ## # #        ## ### ##### # #       #  ## ####  #       #
###   ### # #  # # # #     ## ######  #### ##### ####### # ##     #### ## #   ## ##### #    #### #### ### ##    ## ### #    #             # ##### ##     ## # # ## ##
# ### #     ## # # # #######  #   ### #             # ## #  #####    ########    #  ##### #   ##### # #    ## ###  # ######## ##### ## # ## ####  ## ###### # #######
# # #### ## #  # # # # #     ####  ####### # ## # #      # ## ##### ####      ## ##   ##  # ### # #   ### ##  # ##    # # ##   ##############  ## #                 #
# # ## ###    ## # # # #### ## ### # #   ###############   #        #  ######### ####  #### # #   ## ## #  ## # ## ####      #       ###  ##  ### # #################
#       #####      # #  ##  #          ###  # #### ##    #   # # ## # ## #            #####     ###   # # ##  # #       # # ########## ## ## ## #   ####          # #
# # ###       ## #   # ##  ### ####### # ##     #     # ### #######        #### # # #  #  ### ####  ### # ### # # ######### # ###### #            #      # ######## #
####### # ### #  ### #    ##   #            ### # ### ###   #       ######  ##  # #### ##   #  ##  #### #  ## #      ### #### #        ######## # # # # ##     ##   #
## #  # ####### ##     # ##  # ####### # # ##   ####  ##  #### ## # #  #   ##  ## ##      #   #### ## # # ###   ## #       ## # ########## #  ### ############    ###
#  ##   ##      #### # #  #######      ### ## #      ####### ###  ####   # ######### # # ####       # #       #  #### ## ###      #      #   ####            ### ####
##    ######## ##    # #####      # ## #   ## ### ## #  ###  ### ########### ##  ##  # #  ##  # # #     # ## ###########     ## #   ####   ###  ## # # ## ## ###    #
#  # ##         ## # ##### ###### #  #### ##  #    ####     ## #### ## ## #   ##    ## # ##  ## #### # #####       # ##  ## ##  ###    # #     ############### #### #
#### ## # #### ##### ### #  # ######   ##  ###### ### ##### #   # #       ###    ## ## #####  #### # #     # ### #    ## ## ## #### # ##### ##    #  ### ## #    ####
#     # ######### #### # ## # # ##   ########     #    ## # ### # ##### #     # ##   ###     ###     # ## ##   # # # ### ##  #    ###    ##  #### # ## #      ##    #
#### ####          ##              #   ##   ### # ####                  # ## ## ## ######## ##   ### ####  ## ###### #   ## #### ###########    #        ## #  # ####
#    # #  ####### ######## ### ## ####### #     #### ######### ## ## # ## #  #   #####      ## # #      ##  #     ##### ###    #### ### ## ## ### # # ##########    #
###### #####   ##  # ### ###########  # #### ## ##        # ## #   ###  # ## # ##### #### # ## ### ## ###  ### ####       # ##           # ########## #### #  ## ####
# ##    ## ###  ##        #      # ## # ############## ##      ####### ##  ### # # #      ######## ##   ##   ######## # # # ## ## # ####   # #   ##      #   ##     #
# ## ##      # #### ## ## ######        # # #  ##       ## # # ##       ###### #   ##### ##        ## ##########   ## ##### ##### #    # #     ###### ##   ##### ####
#  ####### #    ##  ## #  # # #  ######   # ##  ###### ##  ### ## ## # ##    #####        ## # ### ##  ## ## #   #######     ##   # #### # ## #### ##  ## ###  # # ##
# ##  #########  ####  ##       ### #### ##  ## # ##    #####  ####  #  #### ## #### # # ########   ##     # # ### ##  ##### ## # #    # #  ####    # ##      ####  #
#  ## #   # # # ## ###  ### ## ##         ## #       # ##     ##    ### ##    #      # #### # # # ##### ##      #   ##     #  # # ### ## # ### # ############  ### ##
##    ###     # #    ############# # ## #    ############ ### ### # ##  ## ##   ## # #  ##           ## #  # ##   #    ## ### ###   #  # # ##      ####  ####### # ##
#  ## # ##### # ####  # #  # ## ## ###  ## #  ## # #### ####  # ###  # ############# # ###### # # # ###### #  ## ## ## #### ###   ### ## #    ## #  # ##            #
####     ##     # ### # ## # ## #####  ###### ## # # #  ## ## #     #### ## #### #   #    ##  # # #  ##    ##  #  ###    #   ## #   #### ## # ## ##   #  ## ## ### ##
#    ## ##  ### # # # # ## # ## # #   ### ##       # # ##     # # #  ##            # # # ##  ####### ## # ##  ## ##   ##   #  ### #  ##  #  #########   #####    ####
######   # ###                    ### #    ### # #        # # ### # #### # # # ## ###### ## ##       ## #  # ###  ########## ###  # #######  #     ## # #   ## # ## #
# ###  #   #   ## # ## ## ###### ######### # ###### # # # #####   # #    # # # #   ##    #   ## ## # ## # ##   ##         #### ## ### ##    ## ########   ########  #
#   ## ## ## #  # # #  ## ###        # #   # ###    ### # #     # ### # ## # # ## #### # # ####### # #  #  # ##### ### ##  ### ##     #####     ###   # #     # ## ##
###     ###### #### # #####   # # ##     #       ##  ## # #######  ## #  ##### ## ##   # #  # ##   # ## ####     #  ##  ##      # # #  ##   ## ##   ### # # #       #
#   ## ##       ##  # # #   # # # #  # # ## ####  ## ## # ### ### ### # ### ####   ## ## # ##    # # #    ## ## ## ### #### ## ## # # ### #  #    ########### # ## ##
## ##  ### ### ########   # # # ### ####### #    ##  ## ###       ##  # #        # #   # ##### # ### ### ###########     ##  # ## # # # # # ## ##     ## # #### ##  #
#   ## #   #    ##      # # # #  ## #       ## #  ## ## #   # # #  ## # ## ## ## # # # # #     # #   #           ##  ## ##  ##  # # #   # #  # ## # #        ##  # ##
################################################################################################################################################################## ##
