# ########################################################################################
# ## # ##      ##  ##    ##             ### ####  ## # #   #  ## #          ##   # ##  # #
#         ####  ##  ####  ####### #####  #   ##  ### # # #   ### ######### #####    ## # #
###########  ##  # ##    ## # ##### # ## ### ### #     ##### # #  ##       # # # ##  #   #
#    #   ### ###      ## #       ##           ## #### ###    # # ##### # # # # #### ## ###
## #   #         #### #  ### ###    # # ##### ## ## # # #### # # ##  ##### # # ##        #
######## # ### #### #### # ###   # ######        ## # # #  # # # ### ## #      ### #######
#        # #   #    ## #    ########   #### ## #        ##        ## #    ### ## # # # # #
#### # # # ########    ### ## ### #  #      ## # # # ##    ######    ######    # # #     #
############ ###    ##              #### # ######### #  ## #    #### ## #   ##       # # #
#     # # #      ##  ### # # # ## #   ## # #         ####### ## ##    # ###### # # # #####
##### # # # # ## ## ##   # #####  ## ##  # ## ## ## ####     #     ##          # # #     #
# #         ###   ##### ## ##### ##   #### #  #######    # ### # # ### ## ### ## # ## ####
#   ## # # ##### #### # #### #    ###  ########       # ######## #  ## ## #    # # ##    #
# ###  # # ##    ##     #    ## # ####   ### #  ## # ## ##    #  ##  # ###### ## # #  # ##
# #   ## #  ## #  ######## #    #   ## ### # ## #  #### #####   ##  #### # ## #### # #####
##### ## ## #### ##  ########## # ######        # ##     ###  #  ## # #          # # # ###
###    ###  #    ###    # #     ##### ##### ### # ###### #   ###  ### ##### ## # ###    ##
#   # #### ##### #   ##     ## ##        ## ##  # #      # # #   ###         # # #   ##  #
### # ## ### #   ## ###### ### ##### # #    ## ## ### ## ##### # #   # # ## #### ###  ## #
#   # #   ## ######## #    #    #### # ## #########   ## ## ##############     ##### ### #
# # ##### #     #  #    ## ## ###    ######   ## #### ####   ## # #   # ### #####      # #
#####     ##### ## ### #####  ##  ## ##     #     ##   #### ### # ###       # # #### ### #
## ######               # ## ######   ##### ## ##    ###  #       ####### #     ##    ## #
#         # # ## ## ## ##    #      # #     #  ### ###### ####### # # ###### ###### ###  #
## #### # # # ##### ## #  ## ### ## #### ## # ##   #                            # #  ## ##
####    # # #  ##   ## # #####   #  ## #### ########## ## ## ## #### # # ### # ## ##  ####
#    ## # # # ##  #  ##### #### ### #   #   ##    # #  ## ## ####    # # ##  #     # ### #
### ##  # # ############          ##### ## ######     ########    ## # ##### # # ### #   #
##  ## ## ####           ## # # # ###      ## # #### ##  # ###### #  # ##    # #  ##   # #
#  ##  ## ##   ##### # # #### ### #   # ##### #      ###   # ##   ## ##### # ### ##  #####
##  ## ## ## ####### # ### #  ##  ## ## #     ### # ## ###      # #   ##   #  ##  ##   ###
### #  #  #  ##      # #     ##  ###  # # ###     #### ### ## ##### ###  ### ### ### #   #
#   ######## #  #### ### # #  #### # ######### ## ###      #  ##     ###   # ##    # # # #
## ##   ###  ## #     ####### ##   ### # #      ### #### #### ## ## ##   # #  # # ## # # #
####  #     ###### # ##       #### #       # # ###       ###  ## #   ## ## ## ### ###### #
# ### ### #### ##  # ## # # # #  # ##### # ######  # ## ##   ###### ############       ###
#     #   #       ## ## ########         #### #   ##### ####   ##      #####     ## # ####
## # #### # # ###### ## #      # # # ## ##      # ##  # #    ###  ## #  ##   ## ##  #    #
#  # #    # # ##     ##### ###   ############## # ###   ## #   ##### ###### ##   ## ### ##
## # ## # ###### ###  ## # ##  ###  # #         ### ## ##  ## ##         ##  ## ##   #####
#  # #  # #      #   ##  ##########   # ### ## ##    # #  ##   ## ## # ##### ##  # #     #
## # ## # ###### ## ####          # #   ######  ## #   # ##  # #  #  #    ## ## ## # # # #
#  # ## # #   ##  # ## #### #####   ## ##      ###### ##### ## # ### ## ######   # # # ###
## ###  #####    #####  ######    #  ##### # #   ###  #      ### ##  #     ##  # # # #   #
#    ## ##    # ## # ##    #   ## ## ## #  #### ##   ##### #   ##### ## ## ## #### # ## ##
############# #### # #####   # ## ## #    ###   ## # #     # ###     #######   ##  ###   #
######## ######      #     # #  ######### # ## ##  # #### ##  ######   #  ## #  ##  ### ##
#    ##  #      # ##   ##### # ###  #     #    ## ## #     ##  ##    #   ##  # ### ##    #
### #### ###### ###### ##    ### ##   ### ####  ######## #  ##  #### #####  ## ##   ## # #
#    # #  ## #####     #  ## ##     ##### ##   ##   #    # ##  ##    ########   ## ##### #
#### # # ##  # # ######## #  ###### ##    #  #  ###   # ##  ## #  ##        ## ##  ##    #
#         ## # # ### ####### #      ### # ## ## #   # # ## ### ## #  ## ######  ## ### # #
## ## # #        # # # ### ##########   # ## ##### ## #  #   # ## ## ##      # ##   ## # #
#  #  ### ######        #  ## ## ###  # ###  # #####  ## # # ######  ## ########## ##### #
#### ##   #   ###### ##   ##     # ## #   ## #  #    ##  # #   ##   ##  ##### # ##     # #
# ####### # #        ####    # #      # #######   # #### # # ######  ##         ## ## ## #
#   # # ####### #### # ##### ####### ## ## ## ### ####   #####   ## ##### ##### ## #######
###   # ##  ##########       ## ###   #  # #      ##   # ##  # #      ##      # #     # ##
#   #    # ## #        # ## ##      # # ##   # # ##### #    ## ## # # ## # #### # # #    #
########   ## ###### # ########## # # # ## ### # #     # ##  ###### #  ###    # # ### ## #
#      ###           ##### #      ### # ## #   # ### # #  ##  # ### ####   ###### ##   # #
## # #     # #### # ##       # ##  ## #### ## ## #   # ##  # ## # #    ###    ##  ## ### #
####### # ######  ########## # #  ######   ## ## ### # #  ## ##     ###### ###### ####   #
# #  ###### ## ## ## ##      ####    ##  # ## #  #   # ##  #  ### #  ##        ##    # # #
#   ## #          #     ### ##    ##  ## #  # ###### ###  ## ##   # ##### # ####  # ######
# #      ### # ## # # # ##  #  ## ## ##  # #######   ####  # #### #    ## #   ## ##      #
# # ## # #   # ## ### ######## ## #   ## #   ##    #    ####  ##### # ##  # # ##  # # # ##
# ###  ##### # #   ## ##        #### ### # ###  ## ## # ##   ##     #  # ######  #########
###### ##    #### ##   ### # # ##    # # # # ## ####### ### ####### # ##    ####      ## #
#   ## ## ## #    ## # #   ### ##### # # # #       ##     #  ##     ##### ###  ## # #    #
###    ##  ###### ## ##### ##     ####   ###### ####  ## ## ##  ###   ##      ### # # ## #
#   ## ### ##     ## ##    ### ####    # ##     #####  ###   ## #   #  ## # #   # ### ## #
# ###  #    #####  # #  ## #    #### # # #### #    ## ##   ####### ## ### ### #########  #
#  ### ### ##     ## ## ## ## #   ## # #  ##  ## # ######### # #   ####   ##  # ### ######
# ## ###   #### # ## ##  ###### ###  # ## #####  # #   #         #   #### ###     #      #
# ## #### ##    # ##  ##  # #    ### # ####     ## # #   ######### #  #####   # #   ### ##
# ##      ## ## # ### ### #   ##  ## # # ##### ##### ## #### ####  ##     ## ## # #  #####
#  ## # #### #  #  ## #   #####  ##  # #    #   # ## #  #         ##  #####  #### ##     #
# ##  #####  ## ## ########     ### ## ## #   #    #### ## ## # #  ##     ##   ##  # # ###
# #####     ##   ###        # # ##   ######## ######     ###  # # ##  ### #  #  ## # #   #
#  ##   ## ##  #   ###### # # #  ### ## ## #       #### ##   #### ###  #### ## ### # ## ##
# #######  #  ## ### # ## # ### ##   ##      # #####    ## # ##    ###    ####   ######  #
### ###### ## ## ##       ###   ## #  ## ### # ###   # ##  # ## ####   ####    #  # ##  ##
#          ## ##  ##### # #### ##  # ### ##  # #   # #########    ####    # # ###    ##  #
####### # ##  #  ##     ### #   ###### #  ## # # ###      ##   ##   #### ## #   # ##### ##
# ##    #  #####  ## # ###    # ### #    ##### # #   ### #### ##  # #     # # # #   ##   #
#    # ###  ##   ####### #### # #     # ###    # ###   ####   #  ## # # # ### ### #  ## ##
### ##  ###  ## ## ###        # ## # ## # ## # # #   ###    # ## ###### #  ## ### ## #   #
#   ## ##   ######   ###### # # #  ###    ## # # # #   #### # ##  ## #  # ###   #  # ### #
###  ###  #### # ## ######  # # ## ##  ## #### ###### ##    ##### #    ## ##  # # ## ##  #
#   ##   ##                #### #  ### ##  ##  ## #    ## #    ## ####  #  # ## # ####  ##
### ## # ## ## #### # ## #    #### #   ###  ## #    # ### ## #  # #    ## ####  #  ##  ###
#   ## # #  #####   # ## # # ###   # #   ## ## ## # #   # #  ## # ## # ##    ## ##  ## # #
# #  # # ## #   # # # ## # ###   # # ## ##  ##### ### ### ## ## #### # #  # ##  #  ##  # #
### ## # ######   ### #  ##### # # # #   ## #      ## ###### ##  ##  #### #  #### ####   #
#   ## ### # ## #   # ##  ##   ### ### ###### # ## ##   ## #########  ##  ##  ##    ## ###
# ###  #        ## ## ########  ## #   ##  #### ## ## ###      # # # #### ###  ## # ##  ##
#   ## # # # ##  # #  #        ##  ## ####      ##  # ##  # ##         ##   ## ## #  ##  #
######################################################################################## #
