# #############################################################################################################################################
#   #   ## # #  ## # ## # ####    ##    # #  #   # ##   # #  ##  #  ##  # # #  # ## ## #  ##      ## ## ##   ##  # # # ## ## #   # #       ## #
### ## ##      ##    ##    ##  ##    ## # ## ### #  ## ## # ### ## ##  ##   ## # ## ## # ##  ######   #    #### ## # # #   # ## ## # #######  #
#      #  # ##  ## #######  ###### ###    #   ## # ##  ##   # # ##  ##  ## ##     # #    ###    # ## ## ##### #          #   ## ## #     # ## #
###### # ##### ##  # ##  # ## ## ######## # #      ###  # ### # #  ##  ###  #### ## ### ## # #### ##          # ######## # ###  #    # #   #  #
#      ###      # ##  ## # ##  # ##   ##  ######## # ##    ## # # ##  ## # ## #     ##  ##   ##   ## ### # # ##    #  ######## ## ########## ##
### ## ##  # ##    # ##  #  ## #  ###    ###     # # ## ##### #    ## ## # ## ##### ###  ## ##  ###    ### #### #### ## # #  #  # # ##   # #  #
#####   ######## ###  ##   ##    ## #### # #####   # #  ##  # ## ####  # # ## ## #   ## ##   ##   # ######### # #       # ## # ##    ## ## # ##
#  #### ### #  #  ## ##  ####### ## ##   # #  #  #     ##  ## ## #  ## # # ##    ### ##  # #### ###  #   ## #   # ##### # ## # ## ####     #  #
## #    # # ## ## #  ###  ## #    # #  # # ## ####### #### #     # ##  #    # ####   #  ## # #    # ## #### # ###   # ###  # #  #    ## #### ##
## ####             ## # ##  ## #   #### # #   ## ### # #  ### ###  ## ### ##  ##### ## ## #   # ##     # # #   # ###  ### # ##   ##### # #   #
#   #### ## ## ### ###   ### ###### # #  # ## ### # # # ## ##  # # ##  # #  # ## # #     # # #####  ##### # # ###  ## ##     ## ####  # # # ###
###      ## #  #    #  ### # # # #    ##       #         # ### #    ## # ##      # ### ### # # ####         # #   ###    #####       ##   # ###
#   ## #  #########   ##   # # # #### ######## ####### # # # # ## ###     ## ##### ##   #  # # # #  ## # #### # ###   ####  #  #######  #     #
## ##  # #### # # # ######       ###   ###  ##  ###    ### #   #  # # #####    # # #  ### ## #     ########       ###  ####   ###### # ########
#  ### ####          # # ####### # # #     #### # ####  ## ### # ##   ####  ####   ##  ## ## # ###### ####  #######   ##    # ##   #   # # # ##
## #   ## ### # # ##      ###  #   #######  ##     ##  ##  ##     ###    ##  #### #### ## #    ## # #  # # ####   ###  ## ###### ### ### #    #
##### ### #######  ###### # ## # ####   ## ####### ## ##  #### #### # ###### # ## # ## ##   # ##      ## # ## ## ## # ###     #  ### ###   ####
#     #      #    ##   ## # #    #  ### #   # # #  #   # ##  #   #    ###    # ## # #  ## #####  ## #### # #      #    #  # ### ##       #    #
############   ##  ### ## # #### # ## # ## ##   ## ###    ## ### # #### ####   ## # ## #   #  ## ######    # ###### ## # #####  ## ########## #
#    # ### ### #  ##    # #   ##         # #### ## ##### ##  ##      #    ## ###    ##   # # ##    ## ####       #  #### # # ## #         #####
####   # #  ######### #     ####### ####    ##   #   #    ## #### #### ####   #####  # #####  ## ###   ##  # # # # ## #      ##   ### #####   #
#  ### # ## # #     #######  ## # ###  ### ##### ### ### ###   ##  # # ## ###  ## ## # ## ### ## # ## #### #######      # ###### ## ### # # ###
## #     ## # ##### ##      ##     ### ##   ##   ### # # ##  # #  ##      ##  ##  ## # #       # #  # ## #  # # ## ### ##   # #   #  ##     # #
#  ##### ## #   #   #  #### ###### #   #  #  ## ##   # #  ## ####  # ####### ####  # # # #######   ## ## # ## #      #  ## ## # ### ### ### # #
# ####      ###   # ####     ##  # ### # ### ##  ### #   ##   # # ##   ####  #####   #     ####  # ## ##        ############# # #   ##  # ### #
# ## ##### ## #####    #### ####    ## # #      ##   # ###  ###      ###  ##  ## ### # #####  ## ####  # ######## # ##  # ##  #   #####    #  #
#  # ##     # # ##### ###     ## ##    ########  ### # # ##  #### #### ##  ##  # ##  # ####  ##   # # ##     ## # #  ##    # ## #### #  ##   ##
##    #####       ##    ##### ###### #  ## # ## ##     # ###  ##  ##    ##  ##    ##      ## ### ## # #  #####  # # ##  #### ## ## # # ### #  #
#  ## ####  ### #    ##       # # #####      ## ######    ### ### #  ##### #### ###  ## ####  ## ## # # ## ##  ##    ## ###  ## ##   # # ######
# ##  #  #### #### ##### # ##   # # # # ## #  # #  ##### ## #  ## # ####    ##   #  ##### #  ##   #   # #   ## #  ####    ##  #    # #    # # #
#####   ## #    #####  # ###  #   #   #### ##     ## ### ## ##  # #  # ## ###### # ##  ## # #### ## ### ## ##    ### ### ##  ## # #### ##     #
### ### ## ### ## # ## ###   #### ## ### ###### ###      #  ###     ##    ###      #  ##  # # ##  #  ##       ####    ##  ## ## ### #   ## ####
# # # #    ###  # # ## ### ######        ### ##  ####### ##  ## ###  ## ### #### ### ####      ##   ##  #####   ## ####  ### #   ##   ####### #
#       ##   ## # # ## # #### # ######## # # #  ## #  #  #  ##    # ###  #   ##   ##    ##### ##  # #  ##  ####### ## # ###    #    #  #  # # #
## ## # ## ###      ## # ##      #         # ##  # ## ## ##    #######  ## #### #  # ##### #  ### ####  ##    ###  #    # ### ######## # ## # #
####  ###  ##  ####  # #  ######   ## ## #    ## # #  ## ## # ##   # ## #   # ####     # # # ##   ## # ##  ####   ## #### # # # ######## ## # #
# ## #####  # ##    ## ## # #  ## ######### ###      ##   # ###### # #    ### ## # # # #   #  ###  # # ## ### ## ##  # ## # #       # ##      #
#  ####  ## ##### #    ## # ##  ###     ### # ######  ###    # ##    # ####    # # #######   ##   ##   ## # #     ##    # # # #####    # # ####
## ## ##     # ####### ##    ##  ## # #  #    #   ### #### ###  ####        ####    ######## #  # ## #      # #####  #### # # ### ###### #    #
#        ### # # # ##  ##### ## ########   ## ## ## #   ## ##  ## #  ########  ## #  # # ##  # ##### #### # #     ##  # # #        # # ### ####
##### # ##     # #  ##  ## # ##   ## # ## ##   # #    # #   ## #    ##  ## ## ###### # # ### #  ## #  # ##### ####### #     #### ### # ##   # #
#  ###########   ## ### ## # ## #### # #   ###   # ## #   #### # ##  # ###  #  # # #   #  ## # ###   ##  # #  ## ##     ###   ##     #  ## ## #
##  ## # #######    #        ##  # # # ##### ### #### # #  # # #### ## # # ## ##   # ### ##    # ## ### ##   ##   ## ##  ############# ###    #
### #    #     #### ######## ###     # # # # # # ## ##### ##   ## #      #     ## ## ##   # ##    # #    # ###  ####  ####      # ##   # # ####
# # #### #### #####          # #####                ## #   # # #  # ###### #####  ##  ## ##  # # ##   #### # ## # #  ###   ## #      #        #
#    ### #     #  ##### ## # #    #### # # # ## ### ## # ### # ##     ###  # # ## ## ##     ####  # #               ## # ######## #### ## # # #
## #     ##### ##   ##   ###   #### ############# #      ##### #  # ### ##     ## ##  ## ##    ###### #### ## ######## #     #  #####  ## # ###
#  #####  # #  #### ### ##### ## #   ## # # # #   ###### # ##  # #### # #  #####  ## ##  ######### #   #####       ##    ## ## #### ##  # #   #
###### ##   ## # #   #####     # ### #  #   # ###    # #    ## # # ## #   ##   ## #   ##     ### # # ### ##### ###    ######## #  # ####### # #
# ##      # #  # ## ## # #####       ##   #   # ####     ##### # #  # # ##### ### # ##### #### # #           #   ## # #### # # # ## #   #######
# #### #### ## # #     # #     ##### ###### #        ###   ##    # ##    #  # # #    ##     ## #   #### # ######  # #        #   #    ###    ##
# # ####         #####   ## ## #     # # ##### ## ###### ##### # #    #### ## # ## ##### ####    ###  # ##### ######### ###### ### ##  #  ##  #
#    #### ## ###       #############      ## #### ###    # # ### # #### ##      ## # ##  # ## #####  ###### # # ## # ##### # # #    #### #### #
#### # ####    ## #### # # # ### #### ### ##    ### #### # # ##      ## #  ####### #  ##    #     ##   ## #      # # # # # # # # ##   #     ###
#        #  #######    #           #### #  #### ##              # ##### # ##   ##  # ### #### #####  ###  # #### #                ##### ### ###
######## ##### # ##### ### ###### ## #    ## #   ### # # # #### #### #     ## ####       #      #   #####     ###### ### # # # ##  ###    ### #
#         ## # #     # ##  #           ## #  ###   ####### #     ##  ### ###   ##  ## ##   # # ## #### #  ##### # #   ###### #  # ##   ##  #  #
#### # ##      #####      #### #### ## #    ## # #####  ########  ## # # #####    ###  ## ####### ## # # ###    # # ### # ##### #  # ####### ##
#    #  # # ##       # # ## ###############       ## ## # # ##   ##        ##  #### ####     ##              ####    ## #    ## # ##   # # #  #
# # ## ######  # # # # ####   #    ## # # ###### ##   # #    ### #  ######### ##       ########## ## ## ## #   ## #####   #########  ###   ## #
#####  # # #  ########  # ### ## #          ## # #### # ### ## # ##       ##  ## # # ###  ### #   ##  #  # # #          #   # ## #  ## # #### #
## #####     ##        ##  #   ######## # #    # # #         #   #  #######  ##  # ####  ## # # ############## # # # # ######  # ##        #  #
#      ##### ### # ## ####   #          # ## #       # # ### ### # ###  ##  ##  ######  ###       # ## ## # ## #######   # ## ## ## ### ##   ##
##### ## # ### ############# ## ## ## # ###  ## # # ## # #    #        ####    ## ## ## ##  # ###       #    # ## # ####    # ##  #   ###  #  #
## ##  #    ##  # # ## ##    ######## #  #####  # # #  # # ##   #### ###    ##  #     # ## ############## ######       # ##      ## #   #######
#   ## #### ### #         #### ## # # # ##     ## #### # # #### #     #### ###### ## ##  # # #   ## ## ## # # #  # # ####### # #    # ###     #
###             ##### ## ## ##        # ## ## ##  #    # ###    #### ## #  ## #   ## ## ## # # ###          #   ####### # #### ## ##### # #####
#   # ######### ## #  ####   ### # ## # ## #   ###### ######## ####   # # ### # ######   # # # #   # ## # #   #             ## #     #        #
### # ##         # #### #  #  #### #  #  #######  ##### ##     #    #             # ## ### # # # ###  ################ #### #  # ###   # ######
# # ###### #####     ## #####      # ## ##       ## ##   ######## # ## ## ## # # ## ##  ##         ##      ### # #####    #### # ##  # #    ###
# ##### ######   # #     ## # #### ###  #  # # #       #      #   ###   ###### ####  # ##  # ### # #### ##           ## #  # #####  ## ## #   #
#  ## # # #    # # # ###      ##     ## ########## ## ####### # # ##### ######  ##  ##  # ## ####### ####  ## ### ##########  # ## ### #  #####
##          ###### ###   # ####  ## ######         ## #    #    ### #     ## ## ### #  ##  ###   ##     ## ##   #      # # ##    #   ####     #
## ## ## ####################### ##### ##  ### # #  #### # ## # ##    # #     ### # # ### ###  #  # ###### ## ### ### ## # #  # ####    ### # #
#  #   ####    # ###              ##    ####   ####### ###    ##### # # ## # ###          ##  ###        # #    #   #        #####   ##   #####
# ### ##    ##       ##### # # # ###### # #### #        ### #  ## ### # #  #     # # ## #  # ## ############## ## #### # # #  ## ###  ###### ##
###   ##### #  # # # #     ### #   ###    # ##### # ###     # ##      ### ## ## ## #### ##   #   ##    #######  ########## ##      ##  # ##   #
#### ##     ## ### # ### ###   ## ##   ## #  ###  # #   # ###  #### #  ##  #### ##    #  # #   ###  #### # # ## ### # # ##### ##########  # ###
# #  ##### ##  ### ####    ## ######## ##   ## ## ### # ##### ##    # ####    # ## ####### # # # ##      # # #### #         #    ##      ## ###
#   ## # # ## ##   ##   # ###### #     #  #       ##  ###      ### ##    ## #####    # ### # #    # ####       ##   # # ## ### #  # ####    # #
## ###     ##  ### #### # #  # # ######## ### ############ # #######  ## ##  ##   ##     ###### #      # # ###### ########## # ##     ## ## # #
#### ## # #######   ##  #### # # # ## # ###   #####     ## ####  ####  ###  ##  # ######  # # ##### #### #  ### #    # #     #### # #######   #
# #     # ## ###  # ###### #          #  ######   ##### ##### ## #    ######## ##     #####     ##     # ##   #   # ## # ###### ###       # # #
#   # # # #      ## #        ## # ###   ## # ## #   ##         # ####      ##   ## ##       ## #### ########### ######            ###### ## # #
### ### ### ## # ## ## # # ###### #   #      ##### ##  # #####        # ####  # ## ## ## # ##    ##  ## #  #     # # # ###### # #    ##   # # #
#   #   ##   ###  #  #######      # # # ## #  ##      ######   ## ## ##    ## # #  ## ##############      ## ###            # ### # ###########
### # #  ## ##   ## ##  # ## ######## # #  ##    # ## #      #  #### ## ##  # # ## ##     ##    # ## ####     ####### # #############         #
#   # # ##  ## #  #####       ##      ### ##### ## #  ## ### # ##    ##  # ## ###  #  ###    #### ## ###### #   # # ###      #        # # #####
### # # ### ######## #### ## ##  ### #######    #  # ##  #   #  ## #  # ##  #   ## ##   # ## # ##  #      ### #       #### #   ## #############
#   # ###   #        #     ##### ##  #       ## ## #  ##### ## ##### ##  ## # # ##### ######## #  ## # ##  ## ## # ##### #####  ###    # #    #
# # ###   ########## ## # ##  ###### ############  ## ##    ##  ##    ## ## ##### #   ##### #    ##### ## ###### #        #####     ##     ## #
# #  #### #   #####   ####### # # ####  ###       ##  #  ## #  ##  # #####     ##   #   # #   ##     ###    ## # # #### #  #  ## ##  # ## ##  #
# #### ######       #   ## #    # # ### # #### # #### ## #  # ##  ## ## ### # ##### ## ##   #### # #   ## #    ###    # ##   ###### ##  ##### #
# ##     ##   # ###### ##    ##                ###     #### #  ####   #   ### ##### ##    #    ### # ####### ####  # ####  #    # #  ##  # ## #
# ###### #########        ## ## ###### # # ### ##### ###    ##   ####   #   #  ##   ## # ## ##   ###   # ##     ## #    # ### #   ##### ## ####
### #     #   ## ##### # ##  ##### ### # # #   #     ######  ## ## #  # # # ## ## #  ###  # ### ######    # ### #  ######  #### ######        #
#   # # #   ###        # ##### #       # ####### # # #      ### #    ## # #  ####### ##  ##   #    ### # ## ######   #####   ##      ## ## ####
###   #####     # # # #### ##    ## ## # ##      # # ## ## ###  #### #######   # ##  ## #### ### #   # # ##    # ###     # #  ############### #
#### ### ### ## # # # # #     ## ####### ## # ## # #######   ## ##     ##  ###    ## ## ## ### ############# #   ########### #######    #     #
#    #       ## # # # #   # # #  #        ### #######      # ## #  # #  ##   # # ### #         ## ### # ## #######   ## #######      ##   # ###
### #### # # ## # ######### ####### # # ###   #   # ###### ####### # ##    # # # ##  # # # # #           #         #     # ## ## ###### ##### #
#   #    ########### # #    ###     # #  ######## # ## #      ##   #  ## # # # # ### # # # # # ## # # #### ###### ### # ##    ## #  # ####    #
## ######## # ## #       ## # ### # # ## # ##        # ## ## ##### ## ## ### # # #   # # # # # ## # #       # # #   # #    ##  # # ## ##   # ##
####        # ## #### # ##  #     # # ####  ########      ## # #   ## #    # # ##### ### ############ # # #     ## ## ## #  # ##    # ## ######
# #### ## #           ##### ## # ###### ### # #      # ## ##   # # ## # # #### ###   ###### #     ##  # # ### #  #  ###  # ##    ##    #      #
#  ###### ## #### # ###############             # ## #  # #  # # #  ### #   ## #   #   ## #   # #  ## # #   ### ## #########  # #### #   ######
## # ##    ###    ####  ## ## # ##  # ### ## # ## #  # #### #### ##  ## # # ## # # ###      ######  ### ###   #### ## # #  ## #  ##  # #    # #
#  #    ######## ### # ##     #  #######  #  ######### ##      # #  ##### #  #####  ## # # ### ##  ##   ##  #  ##         ##  # ###########   #
##   ######   ## #     ###### ## # # # ## ##  # #       ## ## #####   ##  ##### ### #  # ###    # ##### #  ## #### ########## #         #######
#  # #      #    # # #  ###                ##   ##### # ## #      ## ##  ##         ## #     # ## ##    ####   ##      ##   ### ##### #       #
# ## ## ## ##### ### ##     ## ## # ## # ###  # ### # # #  # ## # #   ## ### ### ## ## ### ###  # #####    ## ##  # ##    ####      # ## # ## #
#  ######  ##    #   #  # #  #  ### #  ###### ###     #### #### # ## ##    ##### ##  #  ##   # ##     # # ##   #### ## ##    # ## ### ####  # #
## ##  ###  ### ### ### # ## # ###  ## ##     #### # ###      # ###  ## # ##     ##### ##  ####### # ## # ## #   ##  # ##### # ##   #   ## ## #
#   ##     ##   ##  ##  # #  # #   ##  #  ### #  ###   ## # ### ####  # #  ## ##    ## ###   ## ####  # # ## # #  ## # #   #####  ### ####### #
# ########################## ##### ## ### ##### ##   ###  #   # #    #####  ###  # ##    # #       #### #  # # #######   #### ###   #       # #
# ## #####       # ##    #    ##    # #   #      ###  ## ### #### ##   # ####### ###### ##### # ##    # # ## #  #   ## ### #   ## ### ##### # #
# ##       # # #      ##   # ##  # ## # # # # ##     ##   ## #     ## ##           ##       # #  ## # # # ## ##   # #        #  #  ##     # # #
############################################################################################################################################# #
