# ##############################################################################################################################
# # # # ##  #  # ##     ##   # ## # ##   ##     ##  # #   ##  # #     # #  ## #   # #         # # # ##   ## ##  #       ## # # #
#   # #  ## # ## ## ######## # ##   #### #  # #### ##   #####   ## #### # ##    ### # #########     ### ##   # ## #######    # #
###     ##       ## ## ##  #   ### ## #    ##  ##   # #  ## # ####  ### #  ## ### # # # ###   ## ####      #       #####  #### #
##  ###### #######      ## # ###   ## ## #### #### #####  # #  ##  ##     ##   ## # # #   # ###   # ### ##### ## #       ##    #
#  ### ##   ## #   #######     ### ## #   # ### #  # #### # # ### ##### ##### ###   #   ### # # #          ######## ## #    ####
##  #   ## ##  ## ### #  # #######    # ###  ## ## #  ##  # # ##  ##  #           #   #         ## ## # ####    # #### # ##   ##
### # ###   # ##    # # ## ## ## ####     ##  # #    #### #    ##  ##   ###### ## # ##### ## # ########      #### ## #####  #  #
#       # ### ### ### # #      #  ##### #### ## ## #  ##  # ##### ### ### ## ###  #    ####  #### ## ### ###### # #   ####### ##
#### ## #   #  ## # # # ## ##### ##      #       ####  ## #   # # ##  ###  #   # ### #    ####  # ##   ### ## # #   #  # # #####
# #  ###### # ### # # # #      # #### ## # ######## ##  # # ### #  ## # ## # ##### ########  ##      ##### #      ###### #     #
# ## # # ##    #  #   # # ######  # ###  # # ## ##  ### # #   #   ##          # #        ## ### ## #  ## # # ####### ###   #####
# ##   # ##### ##   ### #   ###  ##  ### # #     # ## # #   #   #  ### # # # ## # ##### ##       # ##  # #               #  ## #
# #  ###  ##      #  ##   ### # ####  #    # ##### ## #   #### ###     ######## #     ##### ### ## ## ## # ##### # ### # ##    #
#   ## ##  ### ## #######  ## #  # ## ## ### # # # ## ## ### #  ## # #  # ####    ## ### #    # ####           #########  # ####
## ##   # ##   ####### #  ### # ## ## #   ##     # #         ####  # # ##  # # ########  # ###### ### # ## # #    #   ## ####  #
#   ## ##  ### # ##  # ##   # #  # ## ## #### #### ### ##### ## #### #### ##    ##  # # ##     #    # #  # #### #   ######    ##
### ## ## ## # # ## ## #  ### # ##  # ## ## #  ##  # #   #####     #####  ## ####  ## # ### ##   ## ### ##### #####   # #  #####
#    # ##  # #   ##  # # ###  #  ##    #    ##  ## #   ###  ### ####   # ### #  # ###        ########## # ##    ####### # ## # #
#### #  ## # # ###  ##   # ## # ##  #### ##### ###   ### ##   #  ##### # ##    ## # # ######  ###     #   #  ##    #           #
#    # ##  # # ##  ### ### ##   ## ####    ##    # #  ##  ## ## ##  #       ##             # ##   ### # #   ##  ##   # ### #####
####    ## # #  ## # # ##  #### ## ## # ###### ##### ### ##        ## ##### #### ## # ########  ######### # ######## #   #######
# #### ##  # ##  # # #  ## # ## ##  # #   ##   # ##  ##     #########     #    #  # # ##### ## ###    ##  #       #### #  #    #
#  # # ## ##    ##   # ##    ## #  ##   # ####    ## ## ###### # ## # # #### ########              # ##  ###### #  ######## ####
##   # #   #### #### #  #### ## # ##  ##### #  ####  #   # ##         ######### #  #### #### # ## ###### # ## ### ##    ###  # #
####     #  ###  ##    ## ## ## #  ##  # #  ## #  ##   # #    # #### #### # #   # ## #####################     ###### ### # ## #
# ##### ##### ##  # ##### ## #  # ##  ## # ##    #### #### ####   ##          #        #     ### # # ## ## ##### ## # # # #  # #
# # ###   ### ## ##  ## #  # ##    ## ##    ####  ##    #    ######### # ###### ### ##   # #   #      #    ## ## ## # #   ##   #
# # # ## ## # #   ## ##   ##  ## ###  #  #### #  ##  ##   ## # ###   ##########   #  # ##### # # ###### #####  # #      ###  ###
# #   ## ##   ## ##  ### ####      ## ##  # # ##    #####  #       #### #     ## ### #  # ###### # #  #  # #  ##   ## ####  ####
# ### ##  ###     ## # #  ##  ## ###  ## ## # #  # ## ####### ######  # # ###  ### # ####   # #  # # ## ##   ##  ###   # # ### #
# # # ## ###### # ## # ## ## ######## ##        ##    #     #    # # ## # # ###### #### # ### ##      # #  ###  ## ###     ##  #
# # # #   # ##### ##    # ## #####       ###### ## #### ##### #### # ## #    ### # ##      #  ## ###### # ##   ###   ### #### ##
# #   ## ## # ##  #  ####  #  ## ##### #    ########  #   #######    ##   #### # # #  ### ## ###     #       #     #####       #
# ## ##  ##   ### # ###   ## ##   # #### ####  # ####   #   ##  # ##### #### #       ## #### #   # #   ####### # # ### ### # # #
#     ##  ## ## #     ## ##   ## ##  ##       ## # #  ### #### ##     # ## #   # #####   # #   #######      ######       # #####
#### ####       ## ####   ## ##  #  ##  # ######     ######  #  # #####      # #       # #   ########## ##### # ### # #######  #
#### # ###### ###  ## ## ##  ### ## #  ##### # # # #     ### ##         # # ##### ## ##### ##### # # ##    ##     # ### # #   ##
#       ##     ### ##  #  # ## # #    ## ##  # # #### #### # #  # ######### ########### ## # # # #    # ##    # ######      #  #
##### ##### ## # # ### ##    # #   # ###  ## #    # #          ##   ####  #  # # # ###  #          ## ###### ##  # ##  #########
# ##  # ###### # #  ## ## ####   ######  ### # #### ### # ###########    ###       # ## # ####### ###  #   ####### ## ###      #
#  ## #  # ##  #   ##  ##  #### ### # ##              #####  #   #    #### ### # # #  # #       ### ##   #####     ## #   #### #
# ### # ##  ## ## ##  #### # #  # # # #  # ### ###########  ## ### #######  ######## ##   #####     ## ### # # ######   #  #####
# ##  # #  ##  ##  ## # ## # # ## # # # ####    ## ## # #  ### # # #  #  ##   # # ##    #     # ########   # # # ###  # ##     #
#  ##   ##  ## ## ### # #      ##         ##### ##  # # # ###        ## ##  # # # ## #### ### #      #### ## # #   # ##  #######
# ##  #### ##  ## ##  # ### ##### ##### # #  ##### ## # # # # #### #     # ##           #  ##### ## ## #         #   ###       #
#  ##  ##   ## #   # ##  #   ## #    #######   ##                # # ###   ######### # ###   # ######    ## ## #####   ## ## # #
# #### ## ###  ### #  ##   #  # # #### # ##  # #  #### ## # # ###### #####  ### #########  #       ## #######      # ######### #
#  ##   # # ## # #   #### ##### #   #    ## #####    #### ###   # ##    ## ##         # ##### # ##     ##   ## ######## ########
## #### # # ## # # ###### # ##    ### ####    # # ##### #   #####  ## #  #    ## ###### # # ############# #  #   ## # # # ## ###
#   # # # # ## #   #  ##       # ##     ## # ##         ## ####   ##  # ## ## ##### #        # # ###### # #### #    # # #      #
###   # #    # ## ## ##  ## ######### #### ###### # # ######    #############         ### ##                 ######       ### ##
#### ## #### # #  ## #  #####   # # #       # #   ##### #    # ##      # ## # #######   ##### # # # # ### ##  # ####### # ######
# #  ##  ##  # ## ## # ## ##  ### #   # # #     #   ##    ## #  ## ##### #  #       # #    #### ### ###    ##         # #      #
# ## ### ### # #  ## #     ##   # # ##### # ## ## #  # ##########  ### # # ################# ####   ### # #### # # # ##### #####
# #   ## # #   ## ##   ## ### ### # # ##### ## #####          # # ##            #### #    #     ###   ###    ##### #   ##    # #
#   #    # # #### #  ###### # ##        ### ##    ## ##### ####    ### ##########    # #### # ### ######## #    ##### #### #   #
# # ## #      ##  # ##   ## #    ### ##   ###  ##### ### #####  ####          #   ##     ## ####        #### ##   ##### #### ###
######## # ##  ## #  # #### # ##   #### ######## # #      ## ##  ### ### # #### #### ######  #   # ## #  ###### #  # #    ## ###
## # ######### ## # ##  ##    ## #### ####     #   ### ##       ##     # #       # ###      ## ###########    # ##     ####### #
#    # ###     #     # ##  #####      ###  ###   #   #  # # ### ## ######## # # ##  #  # ####       ###  # ## # ## ###### # #  #
# ##       # # ### ###  # #### ### #### ##   ### ### # ## # ##      ### # ##### #  ## #####   ####### ## #  # # ## # ## #     ##
###### ### ### ### # # ##        ### ## ## #####  ####### ##### # #       ## #### ### # # ## ## # # #  # # ######         ###  #
#        ###   #          # #######      # ### # ##   # ##### ###### ####  #  ##        # #       # # ##   ##  #### ############
## # ### #   # #### #### #####    # ####       #    # #   # # ## ##   ###### ##  # ## #     #### ##      #  ##   ##            #
############## ##   ## ##### # #### ## # ############## ### #     # #           ######### #####     ## # ##  # ###### ### # ## #
####    ### #     #     # #            ####      ### #        ##### ### ## # #### # ## ##     ## # ##### #####  ## #############
## ####  #    # # ## ##     ### ## ###### # ###### # # ## ###     ######## #            ##########    #### # ##  # # #   # ## ##
#   #### #### ### #  ## # #   # ##      #    # # #     ###### # #  ## ## #### # ## ####         ####### ## # ## ##     # #     #
###      ##   ##  # ##  # # ### ## ## #   ##     # ##### ## ########        # #  #    # ## ## #                  # #####   ### #
###### #  ###  ## # #  ## ########  ### ##### #### # ###    ###  # # ###### # # ## #### ##  # # ## ### #### # ##   # ### # ### #
#   ##### #   ##  # # ###        # ######## #####      # #### ##       # ########     # ## ####  #   #    ###### #     ##### ###
# # # # # ### ## ## #   ### # ####                # ##   ###     ### #          #### ####    ## #### ### ### # # ######## ## ###
###            # ## # #   ###   ########### ## # ##### #   ## ## ### # ## #####   ## #  ## # ##    # ##  #     #               #
#   ## # # ## ##  # # # #  ## #  ### # # ##########  #######   #   ###  #     # # #    #####  # ########   ## #### # # # # # # #
### ## # # #  ## ## # # ####  ##            # # # ##   ### # ######### ############## ### ### ##### ## ###  #   ## # ### ### # #
###### # # # ##   #####    ##  #### # # # #        # ### # # ## #    #  ####  ## # #### #   #           ### ## ##  #  ##   # # #
#      # # # ## ###     ######    ######### ## ###                # ###      ##    # ##   ######### ##### ###########  # # # ###
## ## ######  ######## ###   ## #   ##    ###    # ### ################## ##  # ####    #####   ##### #    ##   # # # ######   #
####### # ## ####  ###     #  ### ###  ##   ## ###  ##        ## # # # ########      ####   ###    #    ##### ###   #   # ### ##
#             # ##     # # # ##       ############ ### # ## #                   ########## ## # #### #### ##  # # #######   ####
## #### ## ##    # # ### # # ##### # ### #### ## #   # # ## ## ### ###### ### #         ## ## # ##     ##    ##           #### #
#  #    ##  ## # # #   # # #    ## ### #    #    # # ###### ##   #      #   # # # #######        # #####  ##    # # # # ### #  #
###### ##  ##  # ### # # # # ## ##       ##   ######### # # ## # # ####### #### ####  # ## #####    ## ##  # ############## # ##
#       ##  ## #  ## # # # #  #  ## # # ### #   # # ##    # ## ###      #### ##### ## # #      ## ####  # ###### # # # ## # #  #
# #### ##  ##  ## #### # # # ## ##  # #   #####        ######  ##  ####   #   ##   ##     ########## # ## # #           # # # ##
####   ## ##  ##    ## #######  ## ## # #    ## ######   # #######  # ##### ###  ###  ##### #  # # # #        ## ##### ## #    #
#    ###  #  #### ###     # #  ### #### # # ###      ###        ###     # # # # ## ## # ##    ## # #   # # # ##  #  ####    ## #
#### ##  ###   ##  ### # ## # ##      # # # # # ## #  ### ## # ##   ##### #      #       # ##### #   ###########   ## ### #### #
#     ## # # # ###   ###    # ### # # # # #   ###  ## # #### #  ### #####   # ##   ## ####         #       ### # #     ##  # ###
# ## ### #   #  ## #   ## ###  ## ###########   # ##     # ### ##         ###  ### ##      ## ## # # ## #### # #######    ##   #
###    # ## ### ## ### ##   # ##  ## # # # ###### ### ##     ###### ## ##   # ##   ## # # ######## #  #### # # ## # ######## ###
#   # ####### # ##   # ## #######    #          #   # ## ###### #    ##########  # #### # # ### #########      ## #   #        #
## ##   ##      #  # #  #     ##  ##   # # # #### # # #         ####          ####   ## #     #  ###  # # ## #      #   # ### ##
#  #  # ## ## # # ## ## # # # #  ### # ### ### ###### ## ######## ## ## # ## ##### # ## #####   ## ##      # # ### ## # # ###  #
#### ##  ###  # #  # ## # # # # ###  # #####       ## ##           # ## ###  ##  # # ##     # #       # # ## #  ####  # #   ####
##    ##   ## # # ##### ### ###   ## ### #### ####### ## ## ### # ##  ######    #### ## # ### # #########  ###### ## #### #    #
#  # #### ##  ###  ## # ###   # # #   ## # ##       # #   #   # # ### ##   ## ### #   ###   ###        ## ### ##   # # ####### #
# ##  # #  ##  ## ###     # ####### #         # # ##### # ######### #    ###  ### ## ##   #   # # # ####    # #  #####  ##  ## #
# ###   # ##  ##  ##  # ###       ### # # ## ####     # #  ###   #  # ## ####      ######## ### # #   ### ###   ### ### ## #####
#   ## ######  ## ## ##   ### ## ##   ### ##    # ### ####   # ### ##  #   ## ####### #  ## ####### #  ##     ####   #       ###
## ##    ##   ##  #   # ####   # ####  ##  ## # ######## # #    ##  ## ## ##      ##  ##  #   ## #######  # #      #   ## ## # #
##### # ##### ## ### ##  # # # ###    ####### #      ##  # ## #    ### ##  ## ###  ##    ## #         ##### # # ##### ### ##   #
#     ###     ##  ## ## ##   #   #### #     # # ## #    ##  #### ### #######    ##    # ##  # ## ####     ### #     ####   ## ##
### #   ### #  # ##   # #  # # ###      #######  ### # ####### #      ## # # # ##  # ##  #### ##    # #####   # # #    # #  #  #
#   # # ##  # ##  ## ## #### #   ## # #       ##   ##### ###   ## ## ##    # ##### # ###    # ## # ##    ## # # # # # ## ## # ##
# # # ###  ####  ### ## ##   # # ## # ### # #### #####   # # ########## ## #    ## #   ## # # ## #  ####### # ############  # ##
### #   ##    ## # ###  #### # #### #  ## # #  #  ## ## ##       ## ##   # # ##  ### #### # #  # ##       # #          ######  #
##  ## ##  # ### #   ##    ###    # ##  ###   #####   #  # #####       # ##########     # # # ## ## # # # # #### # # #     ## ##
#  ##  ## ## # #   ##### ###   # ## ###   # #  ## # ### ## ### ##### # #  # # ### ## #### # #  #  ### #####    ########## ###  #
##  ## #  ##   # #  ##     # # #  # #   # # ##          #          ########        #   ####### # ##   ##  ## ########   #   ####
### #  ##  ## ## ## ### ## # #### ##### # #### # ### #### ### ######  #  #  ##### ## ### # #   #  ###    ##### # # #  ##########
#   # ##  ### ##  # #   ## #   ##  # #  #    # # ##        ##### # ## # ## ## ###  #       ## ## #### ##### ##       ######    #
## ##  ####    ## # # # ## # #  # ##   ## ## # ###  ## # #   #                  #### # ###### ## ##            # ###### # ## ###
#  ## ##    ##  # ##### ## ######  ### ##  # #  ### ## # # #   ## # # ####### #    # #    # ######### ## # # ###   ## #   ##   #
## ##  #### ## ######## #      ## ##    # #####  ## ## # # # ######## # #   ### ####### #   ### # # # ## # #   # #      #    ###
#   ## ##    #   ## # # ## ## ### ##### #    #####  ## #####    ###       ######### # #######   #   #  # # # # # # ####### # # #
## ##   ### ## ###       # #### # #     # ##   # #####  ##   ##   ## ## #####          # # ## ### ### ## ##### ###      ## #   #
## ### ##   ##   ## # # ##      ### ## ## ## #       # ##  # ##########       # #### #   # #        ###     ## ##  # ##  # ## ##
#   ## ### #### ##  # # ## # ## ##  ## ####  # # ### #  ## #    ##    # ## # ##   #### ###   ## ## ##### # ##  #  ## ## #####  #
# # ## #   ##   ## ## #  # #  # ### #   ### #### ##### ### ## # #  # ##### ###### # ##     #  # ##    ## # ### # ##  ##   ##  ##
# #  # ## ##  # #   # # ## # ## #   # #   # #       ## ##   # #   ##     #   ##      # ## ### # #  # ##  #   # #  ## ## #  ##  #
############################################################################################################################## #
