#.##############################################################################################################################
#.#.#.#.##..#..#.##.....##   # ## # ##   ##     ##  # #   ##  # #     # #  ## #   # #         # # # ##   ## ##  #       ## # # #
#...#.#..##.#.##.##.######## # ##   #### #  # #### ##   #####   ## #### # ##    ### # #########     ### ##   # ## #######    # #
###.....##.......##.##.##  #   ### ## #    ##  ##   # #  ## # ####  ### #  ## ### # # # ###   ## ####      #       #####  #### #
##..######.#######......## # ###   ## ## #### #### #####  # #  ##  ##     ##   ## # # #   # ###   # ### ##### ## #       ##    #
#..###.##...##.#...#######     ### ## #   # ### #  # #### # # ### ##### ##### ###   #   ### # # #          ######## ## #    ####
##..#...##.##..##.###.#  # #######    # ###  ## ## #  ##  # # ##  ##  #           #   #         ## ## # ####    # #### # ##   ##
###.#.###...#.##....#.# ## ## ## ####     ##  # #    #### #    ##  ##   ###### ## # ##### ## # ########      #### ## #####  #  #
#.......#.###.###.###.# #      #  ##### #### ## ## #  ##  # ##### ### ### ## ###  #    ####  #### ## ### ###### # #   ####### ##
####.##.#...#..##.#.#.# ## ##### ##      #       ####  ## #   # # ##  ###  #   # ### #    ####  # ##   ### ## # #   #  # # #####
#.#..######.#.###.#.#.# #      # #### ## # ######## ##  # # ### #  ## # ## # ##### ########  ##      ##### #      ###### #     #
#.##.#.#.##....#..#...# # ######  # ###  # # ## ##  ### # #   #   ##          # #        ## ### ## #  ## # # ####### ###   #####
#.##...#.#####.##...### #   ###  ##  ### # #     # ## # #   #   #  ### # # # ## # ##### ##       # ##  # #               #  ## #
#.#..###..##......#..##   ### # ####  #    # ##### ## #   #### ###     ######## #     ##### ### ## ## ## # ##### # ### # ##    #
#...##.##..###.##.#######  ## #  # ## ## ### # # # ## ## ### #  ## # #  # ####    ## ### #    # ####           #########  # ####
##.##...#.##...####### #  ### # ## ## #   ##     # #         ####  # # ##  # # ########  # ###### ### # ## # #    #   ## ####  #
#...##.##..###.#.##..# ##   # #  # ## ## #### #### ### ##### ## #### #### ##    ##  # # ##     #    # #  # #### #   ######    ##
###.##.##.##.#.#.##.## #  ### # ##  # ## ## #  ##  # #   #####     #####  ## ####  ## # ### ##   ## ### ##### #####   # #  #####
#....#.##..#.#...##..# # ###  #  ##    #    ##  ## #   ###  ### ####   # ### #  # ###        ########## # ##    ####### # ## # #
####.#..##.#.#.###..##   # ## # ##  #### ##### ###   ### ##   #  ##### # ##    ## # # ######  ###     #   #  ##    #           #
#....#.##..#.#.##..### ### ##   ## ####    ##    # #  ##  ## ## ##  #       ##             # ##   ### # #   ##  ##   # ### #####
####....##.#.#..##.#.#*##  #### ## ## # ###### ##### ### ##        ## ##### #### ## # ########  ######### # ######## #   #######
#.####.##..#.##..#.#.#, ## # ## ##  # #   ##   # ##  ##     #########     #    #  # # ##### ## ###    ##  #       #### #  #    #
#..#.#.##.##....##...#,##    ## #  ##   # ####    ## ## ###### # ## # # #### ########              # ##  ###### #  ######## ####
##...#.#...####.####.#, #### ## # ##  ##### #  ####  #   # ##         ######### #  #### #### # ## ###### # ## ### ##    ###  # #
####.....#..###..##,,,,## ## ## #  ##  # #  ## #  ##   # #    # #### #### # #   # ## #####################     ###### ### # ## #
#.#####.#####.##..#,##### ## #  # ##  ## # ##    #### #### ####   ##          #        #     ### # # ## ## ##### ## # # # #  # #
#.#.###...###.##.##,,## #  # ##    ## ##    ####  ##    #    ######### # ###### ### ##   # #   #      #    ## ## ## # #   ##   #
#.#.#.##.##.#.#...##,##   ##  ## ###  #  #### #  ##  ##   ## # ###   ##########   #  # ##### # # ###### #####  # #      ###  ###
#.#...##.##...##.## ,### ####      ## ##  # # ##    #####  #       #### #     ## ### #  # ###### # #  #  # #  ##   ## ####  ####
#.###.##..###.....##,# #  ##  ## ###  ## ## # #  # ## ####### ######  # # ###  ### # ####   # #  # # ## ##   ##  ###   # # ### #
#.#.#.##.######.#.##,# ## ## ######## ##        ##    #     #    # # ## # # ###### #### # ### ##      # #  ###  ## ###     ##  #
#.#.#.#...#.#####.##,   # ## #####       ###### ## #### ##### #### # ## #    ### # ##      #  ## ###### # ##   ###   ### #### ##
#.#...##.##.#.##..#,,####  #  ## ##### #    ########  #   #######    ##   #### # # #  ### ## ###     #       #     #####       #
#.##.##..##...###.#,###   ## ##   # #### ####  # ####   #   ##  # ##### #### #       ## #### #   # #   ####### # # ### ### # # #
#.....##..##.##.#.,,  ## ##   ## ##  ##       ## # #  ### #### ##     # ## #   # #####   # #   #######      ######       # #####
####.####.......##,####   ## ##  #  ##  # ######     ######  #  # #####      # #       # #   ########## ##### # ### # #######  #
####.#.######.### ,## ## ##  ### ## #  ##### # # # #     ### ##         # # ##### ## ##### ##### # # ##    ##     # ### # #   ##
#.......##.....###,##  #  # ## # #    ## ##  # # #### #### # #  # ######### ########### ## # # # #    # ##    # ######      #  #
#####.#####.##.#.#,### ##    # #   # ###  ## #    # #          ##   ####  #  # # # ###  #          ## ###### ##  # ##  #########
#.##..#.######.#.#, ## ## ####   ######  ### # #### ### # ###########    ###       # ## # ####### ###  #   ####### ## ###      #
#..##.#..#.##..#.,,##  ##  #### ### # ##              #####  #   #    #### ### # # #  # #       ### ##   #####     ## #   #### #
#.###.#.##..##.##,##  #### # #  # # # #  # ### ###########  ## ### #######  ######## ##   #####     ## ### # # ######   #  #####
#.##..#.#..##..##, ## # ## # # ## # # # ####    ## ## # #  ### # # #  #  ##   # # ##    #     # ########   # # # ###  # ##     #
#..##...##..##.##,### # #      ##         ##### ##  # # # ###        ## ##  # # # ## #### ### #      #### ## # #   # ##  #######
#.##..####.##..##,##  # ### ##### ##### # #  ##### ## # # # # #### #     # ##           #  ##### ## ## #         #   ###       #
#..##..##...##.# ,,# ##  #   ## #    #######   ##                # # ###   ######### # ###   # ######    ## ## #####   ## ## # #
#.####.##.###..###,#  ##   #  # # #### # ##  # #  #### ## # # ###### #####  ### #########  #       ## #######      # ######### #
#..##...#.#.##.#.#,  #### ##### #   #    ## #####    #### ###   # ##    ## ##         # ##### # ##     ##   ## ######## ########
##.####.#.#.##.#.#,###### # ##    ### ####    # # ##### #   #####  ## #  #    ## ###### # # ############# #  #   ## # # # ## ###
#...#.#.#.#.##.#.,,#  ##       # ##     ## # ##         ## ####   ##  # ## ## ##### #        # # ###### # #### #    # # #      #
###...#.#....#.##,## ##  ## ######### #### ###### # # ######    #############         ### ##                 ######       ### ##
####.##.####.#.# ,## #  #####   # # #       # #   ##### #    # ##      # ## # #######   ##### # # # # ### ##  # ####### # ######
#.#..##..##..#.##,## # ## ##  ### #   # # #     #   ##    ## #  ## ##### #  #       # #    #### ### ###    ##         # #      #
#.##.###.###.#.# ,## #     ##   # # ##### # ## ## #  # ##########  ### # # ################# ####   ### # #### # # # ##### #####
#.#...##.#.#...##,##   ## ### ### # # ##### ## #####          # # ##            #### #    #     ###   ###    ##### #   ##    # #
#...#....#.#.####,#  ###### # ##        ### ##    ## ##### ####    ### ##########    # #### # ### ######## #    ##### #### #   #
#.#.##.#......## ,# ##   ## #    ### ##   ###  ##### ### #####  ####          #   ##     ## ####        #### ##   ##### #### ###
########.#.##..##,#  # #### # ##   #### ######## # #      ## ##  ### ### # #### #### ######  #   # ## #  ###### #  # #    ## ###
##.#.#########.##,# ##  ##    ## #### ####     #   ### ##       ##     # #       # ###      ## ###########    # ##     ####### #
#....#.###.....# ,,  # ##  #####      ###  ###   #   #  # # ### ## ######## # # ##  #  # ####       ###  # ## # ## ###### # #  #
#.##.......#.#.###,###  # #### ### #### ##   ### ### # ## # ##      ### # ##### #  ## #####   ####### ## #  # # ## # ## #     ##
######.###.###.###,# # ##        ### ## ## #####  ####### ##### # #       ## #### ### # # ## ## # # #  # # ######         ###  #
#........###...#  ,,      # #######      # ### # ##   # ##### ###### ####  #  ##        # #       # # ##   ##  #### ############
##.#.###.#...#.####,#### #####    # ####       #    # #   # # ## ##   ###### ##  # ## #     #### ##      #  ##   ##            #
##############.##..,## ##### # #### ## # ############## ### #     # #           ######### #####     ## # ##  # ###### ### # ## #
####....###.#.....#,,,,,# #            ####      ### #        ##### ### ## # #### # ## ##     ## # ##### #####  ## #############
##.####..#....# # ## ##,,,  ### ## ###### # ###### # # ## ###     ######## #            ##########    #### # ##  # # #   # ## ##
#...####.####.### #  ## #,#   # ##      #    # # #     ###### # #  ## ## #### # ## ####         ####### ## # ## ##     # #     #
###......##...##  # ##  #,# ### ## ## #   ##     # ##### ## ########        # #  #    # ## ## #                  # #####   ### #
######.#..###..## # #  ##,########  ### ##### #### # ###    ###  # # ###### # # ## #### ##  # # ## ### #### # ##   # ### # ### #
#...#####.#...##  # # ###,,,,,   # ######## #####      # #### ##       # ########     # ## ####  #   #    ###### #     ##### ###
#.#.#.#.#.###.## ## #   ### #,####                # ##   ###     ### #          #### ####    ## #### ### ### # # ######## ## ###
###............# ## # #   ###,,,########### ## # ##### #   ## ## ### # ## #####   ## #  ## # ##    # ##  #     #               #
#...##.#.#.##.##  # # # #  ## #,,### # # ##########  #######   #   ###  #     # # #    #####  # ########   ## #### # # # # # # #
###.##.#.#.#..## ## # # ####  ##,,,,,,,,,,,,# # # ##   ### # ######### ############## ### ### ##### ## ###  #   ## # ### ### # #
######.#.#.#.##   #####    ##  #### # # # #,,,,,,,,# ### # # ## #    #  ####  ## # #### #   #           ### ## ##  #  ##   # # #
#......#.#.#.## ###     ######    ######### ## ###,,,,,           # ###      ##    # ##   ######### ##### ###########  # # # ###
##.##.######..######## ###   ## #   ##    ###    # ###,################## ##  # ####    #####   ##### #    ##   # # # ######   #
#######.#.##.####  ###     #  ### ###  ##   ## ###  ##,,,,,,,,## # # # ########      ####   ###    #    ##### ###   #   # ### ##
#.............#.##     # # # ##       ############ ### # ## #,,,,,,             ########## ## # #### #### ##  # # #######   ####
##.####.##.##....# # ### # # ##### # ### #### ## #   # # ## ## ###,###### ### #         ## ## # ##     ##    ##           #### #
#..#....##..##.#.# #   # # #    ## ### #    #    # # ###### ##   #,     #   # # # #######        # #####  ##    # # # # ### #  #
######.##..##..#.### # # # # ## ##       ##   ######### # # ## # #,####### #### ####  # ## #####    ## ##  # ############## # ##
#.......##..##.#..## # # # #  #  ## # # ### #   # # ##    # ## ###,     #### ##### ## # #      ## ####  # ###### # # # ## # #  #
#.####.##..##..##.#### # # # ## ##  # #   #####        ######  ## ,####   #   ##   ##     ########## # ## # #           # # # ##
####...##.##..##....## #######  ## ## # #    ## ######   # #######,,# ##### ###  ###  ##### #  # # # #        ## ##### ## #    #
#....###..#..####.###     # #  ### #### # # ###      ###        ###,    # # # # ## ## # ##    ## # #   # # # ##  #  ####    ## #
####.##..###...##..### # ## # ##      # # # # # ## #  ### ## # ##  ,##### #,,,,,,#,,,,   # ##### #   ###########   ## ### #### #
#.....##.#.#.#.###...###    # ### # # # # #   ###  ## # #### #  ###,#####,,,# ##,,,##,####         #       ### # #     ##  # ###
#.##.###.#...#..##.#...## ###  ## ###########   # ##     # ### ##  ,,,,,,,###  ### ##,,,   ## ## # # ## #### # #######    ##   #
###....#.##.###.##.###.##   # ##  ## # # # ###### ### ##     ###### ## ##   # ##   ## #,# ######## #  #### # # ## # ######## ###
#...#.#######.#.##...#.## #######    #          #   # ## ###### #    ##########  # ####,# # ### #########      ## #   #        #
##.##...##......#..#.#..#     ##  ##   # # # #### # # #         ####          ####   ##,#     #  ###  # # ## #      #   # ### ##
#..#..#.##.##.#.#.##.##.# # # #  ### # ### ### ###### ## ######## ## ## # ## ##### # ##,#####   ## ##      # # ### ## # # ###  #
####.##..###..#.#..#.##.# # # # ###  # #####       ## ##           # ## ###  ##  # # ##,,,  # #       # # ## #  ####  # #   ####
##....##...##.#.#.#####.### ###   ## ### #### ####### ## ## ### # ##  ######    #### ## #,### # #########  ###### ## #### #    #
#..#.####.##..###..##.#.###   # # #   ## # ##       # #   #   # # ### ##   ## ### #   ###,,,###        ## ### ##   # # ####### #
#.##..#.#..##..##.###.....# ####### #         # # ##### # ######### #    ###  ### ## ##   #,  # # # ####    # #  #####  ##  ## #
#.###...#.##..##..##..#.###       ### # # ## ####     # #  ###   #  # ## ####      ########,### # #   ### ###   ### ### ## #####
#...##.######..##.##.##...### ## ##   ### ##    # ### ####   # ### ##  #   ## ####### #  ##,####### #  ##     ####   #       ###
##.##....##...##..#...#.####   # ####  ##  ## # ######## # #    ##  ## ## ##      ##  ##  #,,,## #######  # #      #   ## ## # #
#####.#.#####.##.###.##..# # # ###    ####### #      ##  # ## #    ### ##  ## ###  ##    ## #,,,,     ##### # # ##### ### ##   #
#.....###.....##..##.##.##   #   #### #     # # ## #    ##  #### ### #######    ##    # ##  # ##,####     ### #     ####   ## ##
###.#...###.#..#.##...#.#  # # ###      #######  ### # ####### #      ## # # # ##  # ##  #### ##,,, # #####   # # #    # #  #  #
#...#.#.##..#.##..##.##.#### #   ## # #       ##   ##### ###   ## ## ##    # ##### # ###    # ## #,##    ## # # # # # ## ## # ##
#.#.#.###..####..###.##.##   # # ## # ### # #### #####   # # ########## ## #    ## #   ## # # ## #,,####### # ############  # ##
###.#...##....##.#.###..#### # #### #  ## # #  #  ## ## ##       ## ##   # # ##  ### #### # #  # ##,,,    # #          ######  #
##..##.##..#.###.#...##....###    # ##  ###   #####   #  # #####       # ##########     # # # ## ## #,# # # #### # # #     ## ##
#..##..##.##.#.#...#####.###   # ## ###   # #  ## # ### ## ### ##### # #  # # ### ## #### # #  #  ###,#####    ########## ###  #
##..##.#..##...#.#..##.....# # #  # #   # # ##          #          ########        #   ####### # ##  ,##  ## ########   #   ####
###.#..##..##.##.##.###.##.# #### ##### # #### # ### #### ### ######  #  #  ##### ## ### # #   #  ###,   ##### # # #  ##########
#...#.##..###.##..#.#...##.#   ##  # #  #    # # ##        ##### # ## # ## ## ###  #       ## ## ####,##### ##,,,    ######    #
##.##..####....##.#.#.#.##.# #  # ##   ## ## # ###  ## # #   #                  #### # ###### ## ##  ,,,,,,,,,,#,###### # ## ###
#..##.##....##..#.#####.##.######  ### ##  # #  ### ## # # #   ## # # ####### #    # #    # ######### ## # # ###,,,## #,,,##   #
##.##..####.##.########.#......## ##    # #####  ## ## # # # ######## # #   ### ####### #   ### # # # ## # #   # #,,,,,,#,,,,###
#...##.##....#...##.#.#.##.##.### ##### #    #####  ## #####    ###       ######### # #######   #   #  # # # # # # ####### #,# #
##.##...###.##.###.......#.####.# #     # ##   # #####  ##   ##   ## ## #####          # # ## ### ### ## ##### ###      ## #,, #
##.###.##...##...##.#.#.##......### ## ## ## #       # ##  # ##########       # #### #   # #        ###     ## ##  # ##  # ##,##
#...##.###.####.##..#.#.##.#.##.##  ## ####  # # ### #  ## #    ##    # ## # ##   #### ###   ## ## ##### # ##  #  ## ## #####, #
#.#.##.#...##...##.##.#..#.#..#.### #   ### #### ##### ### ## # #  # ##### ###### # ##     #  # ##    ## # ### # ##  ##   ## ,##
#.#..#.##.##..#.#...#.#.##.#.##.#   # #   # #       ## ##   # #   ##     #   ##      # ## ### # #  # ##  #   # #  ## ## #  ##,,#
##############################################################################################################################,#
