## #############################################################################################################################
##  ## # # #  ## # #   #  #  # # ###    # #    ## ##    #  ## ## # ## ##  ## ##  ## ## ## # ### # # ## # ##      ## ## ## #    #
#  ##  #     ##  # ### ##   ##    #  # ## ### ##   #### ## ## ## #     # ##  ## ##   # #     #       # # #  ####### ##  # ## # #
##  ## ## ###### #  ## #  ####### ## ###  ##   ###  ##  ## #   # #### ##  ## ##  ### # ## ##   ## #### # ## # ## #   ## # #### #
#  ##   #   # #  # ##    ###          ## #####  ###  ## #  ## ## ## #  ##    ## ##     ##### ####### # # ## # #  ###  # #  ##  #
## #### # ### ##   ### # # ####### # ##  ## #  ##   ##    ###  # ## # #### # ##  ### ### ##      # # # # ## # ## ### ##   ##  ##
#             ####   ### # # # # ### ## ###   #####  #### ##  ##    # # ## ##### ##  #      ######   #   ## # ## # # ## #####  #
###### # ### ## ## ###     # # # ##  ## # ### ##    ##  #  ## ##### # # ##  # #   # ## ### ##  # ###   #### # ##     ## ##  # ##
#   ####  ####       #### ##     ### #  #  ##  ## #  ##   ##   # #       ## # ### # ## ###### ##  ### ##  # # ###### #   ##   ##
### # #  ## #### ### ##   ## ### # # ## # ##  ######  ###  ### # #### #####   ##    ## # ###     ##    ##     # # ## ## #####  #
#   # ## #    #### # ####  ####       # # ## ## ##   ## ## ##  # # #   # #  ###### ##    # ## ####### ##### ###   ## ##   ### ##
# #   ## # #### #     ##  ### ##### #   # ## ##  ### #  ##  ## #   ### # ##   ##   #### ## ## ### ##    ##   #### ## #  ###    #
##### ## # # ## ##### ###  #  ## ##### ##     ## #   # ##  ##  # ###   # ## ###### #     #  # # # #### ##  ### ## ## # ####### #
## #  ##   #     ##   # ##   ##  # #   ### ##  # ### # #  #### # # ###       # ##    # ### ## # # # #  #  ## # ## ##   ## ##   #
#  # ### #   ########    ###  ##   ###   #  # ##  #      ##    #     ### ##### #  ########  # # # # ## ##  # # ##  ## ##  ### ##
## #   #####   ## ##  ##   # ##### ### #   ###### #### ####### # ### ##   ## # ##     ## # ## # # # #   ## # # #  ### #  ## # ##
#    ####  # ###  ########   # # # # ##### # ##     #   ##        ###### ### # #### ###  # ## #     ## ##    # # ##   # ##     #
## #### ## #  #  ## ##  #### #   # # ## ##    ##### ## ####### #### ## # #       ## # ##      #### ##   ## ###      ### ### # ##
## ## # #  ##   ##   ##    # ### # # ## #  ####     ##   ## #  # ## #  # #### #####    ## #####     ###  # # # # # ##   #   #  #
#   # # ## ### ##  #### ## # ##         ## # ######  # ###  ##   #  ## #  ##    # ### ##    # #### ## # ## # # ######## # ######
### # # ##  ##    ### ###       #### #####    ##  ##   # ##  ### # ###   ##  ##   ###  ### ##   #  #    ## #    # #  ## # ## # #
##    #    ##  #### #  #### # # #      ##  ##  ## #### # ## ## #   ##  #  ##  #####   ##    ### ## ### ##  # #### # ##         #
#  ##   ###### # ##   ## ## # # ##### ##  #### #  #  # # #       ########  # ###  ### #  #### #     #   # ##   ## # ## #### ####
####### ## # #   ## ###  ###### #     ## ##  #### ## # # ## ### ##   ##### #   ## # # # ####  ##### ## ##  # ###    ## # ##    #
#    #  ##     #### #### # # ######## ##  ## ## # ##     ###### ## ### ##    ###      #    ## ## #      # ## # # ##### #  ## # #
####   ##  # #  # #   ##   #  ### # # #  ### ##      # # # #     # # # #  #### #### #   ####     #### #   ##       ##    ##### #
## ### ######## # ## #####   ##         ## #  ##### ###### ## ##   # # ##  ### ## #####    #### ## #### ##### #### #  ## #   # #
#  #     #### #   ##   ##  ########### ### # ###  # ### #  ##### #   # #  ## # ## ###### ####   ##  ##  ##### ####### #### #####
## ### ### #  # #  ###  ## # # #       ##    # ##    #  ## # # # # #     ##    ## # #  #  # # ##### ###   ##      ##    #      #
#  ##  # #   #### ##   ##      # #####  ## ###  #### # ##  #   ###### ##  ### ##  # ## # ## #  # #    # #### ######## ### ######
## ## ## ## ####   # #  # ########## ## ##  ###         ## # ####  ##### ##    ## # #    ## # ## #### #   #    ### ## #      # #
#     ##  #  ##  ######     # # ##         ## ######## ##  #  ##  ## # # #  ## ## #   # ### # #  ###    ### #### # #    ###### #
### #  ##   #### #### ## #### # #  ## ## # #   ###      ## ##  # ##      ## ##### # #####   #   ## #### ##    ## # ## ###  # # #
#   ##  ###  ##  # #  ##   ## # #####  ### ## ## ######  # ## ##  ######     ##      # #### ## ### ## # ## # ### # ##   ## # # #
### #  ##   ### ## # ##  #### #  ## #####   # #  #  #### # #   ## ## ##  ###  ##### ##  ##  ## ##  ##      ### # #    ###      #
# ####  ### ##  ## # #  ## #    ##  ## #  #   # ## ## #  # ## ##  ## ######  ##  #   # ##  ##   ##  # ## ##### #   # ## # ######
#  # # ##   ## ##  # ## #  ## ##### #  ######   ## ## ## # ## ## ### # ## ##  ## ### #  ## ## # ###    ### # # # #####     ## ##
##   #  ###     ##   ## # ##   # #  ##   ## # ####         ##    # # # ## #  ##   ## # ### #### # # #####      #   ### ###     #
#### # ## # ## #####      ### ## ##  # ###       ## ######  #### #   # ## ## ### ##  # # #  ##  #   ## #  ###### ### #  ###### #
#    # ## #### # # ### #### # ##  ##   # #### ########   # ## ##   ### ##     ##  ##     # #### # ###  # ##        # # ##    ###
#### # ##  #        #  ## # #  # ##  #   ##   #  # # ###      #  ### #  ### # ## ##### ### # ## # # ##      ## ##### #    ##   #
#       ## ## # ### ##  # # # ##  #### ##### ## ## #   # # ## ## # # # ## ### #   # #   #  # ## # # ## #########       #########
##### ###   ######   ##       ###  ##   ## #  #  # # # ######    # # # #  ##  ### # # ### ## #      ##   ###  ### # ##       # #
# #    #  ###  # ## #### # #### ##  ###    ## ## # ### ##   ## #   # #   ##  ##   #    ## ##   ## #### ### ##  ## ##### ###### #
# #### ##   ##       # # ### ##  ## #### #    #  #  ##  ### ## ### # # #  ## ####   ## ## #  # ##             ##    # ####  ## #
#   ## #  ###  # ###      ##  ##  # # ####### ## # ####     ###### # ####     ##  # ##### ## ###  # # # # ###    ####  # # ##  #
###    # ## # #### ### ####  #### #     ##  # #    #  ## # ## #       # ### ##### #  ## # ## ########## #   ## #####  ## # ### #
###### # ## ####   #    # ## ##   # ####### # ## ### #####  # #######    ##     ####  # # ## # # # #  # # # ##     ## ##   # # #
#         # ## ### ## #       # # # # ## #  # ##  ## # #### # # ## ### ###  ######   ##   ## # # #   ######### ######  ## ## # #
# # ##### # ##      ##### ####### #    # ## #  ##  # # #      # ##     ##  ##  # ###  ## ###       # # # # # #####  ## #   # # #
######    # ###### ####    ### #    #### ## ##  ## # # ## ### #  #####  ## ## ## ##  ##    # # #######        #  ## ## # ### # #
## # #### # # ## # ## ### ##   #### # ## ##  ##  #     #####    ## #   ##  ##  # ### ## ## # ###### #  ### #### ##  ## # ##    #
#    ##   # # ## # #   ##  ### # ## # ## ###  ## # ##### # #### #  # #  ## ###   # #  # ## #   #  # ##  ##### # ### #     ## ###
####  ### # #    # ## ##  ## #   #  # ##  #  ##  # #  ##      # ## ####      # #     ####    ### ## ## ## # # #  ## ## ####    #
# ###  #    ## #    # ### ## ###   ##  ##   #### # # ########         ## # ###### ##  ##  ## ##         # # # ## ##  # # ### ###
#  ### ####  ######     # #  ##  # ## ##### ##   # # #  ## ####### ####  ### ## #### #######  ## ######     # #   ## # #  #    #
## # # ## ##  # # ### #     ###### ##  # #  #### # # # ##   # #     # ## ##  ## ###  # ###   ##       ####### # #### # # ## ####
#      ## #  ##   ### ##### # ###   # ## ##  ##  #      ###   #####   ## ## ##    ## #   # ##### ######   # # #  ##       #    #
###### ## # ##### # ###     # # ### # ## ## #### #### #  #### ###   ###  ##  # ####  ### # ## ## ###  ###   # # ### ### #   # ##
# #          ##     ### # #     #     ##    # ## # ## ####  # # ###   ## ### #  # ## # # #           ## ## ## # # # ###### #####
#   ## # # #  ### ### #########   ## ###### #  # # #   # ##      #  ####  ##   ## ## # # # ##### #####      # # # #     #### # #
## ##  # # ##     # # #     # ### ######### # ## # ### #  ###### # ###   #####  # #           ########## ## #       ##### #    #
###### ########## # # #####   ###   # ##    # ## # ##  ##  ##        ###   ##  ## ### #########      ######   ### #     #   ####
# # ####          #   ## ## #     ###  ## ### ##    ##  # ##########     #### ##  ##   #    ### ## ### ##   #   ### ##### #    #
#        ######## # ###   # # ### ####  # # # #### ####    ##  #  ##### ##       #####   #### #  # ##  ## ### ######### # #### #
####### ##          # ## ######      ##     #  ##  #  ### ####   ##  ## #### ##### #   # ###  # ######    ####### ##  #      # #
#  ######  ######## # ##  ###### ## ##### ### ####   ###  #  ### ### #    ## # ##  ##### #   ##   ## # ####  ## # #  ## ########
## #   ## ### # ##    ## ## # ####   ## #  ## ## ###   ## ##  #   ## ## ###  #  # ## ##    ###  ###      ## ##    # ##         #
#  ## ######     ### ### #       ### #  ##     # ### ###  ### ## ###  # # ##   ## ##  ####   ## # ## ## ##  ## #### ## #########
##     # # ##### ### ##  ### ## ##   ##  ## #### # # ##  ## # ## ##  ##   ####  # ## ##    ###     # ###### ##  ##  #   #### # #
###### #   # # # # # ## ## #### #### ## ##   ##    # ###  #      ###  ###   ## ##  #  ####   ## #### # ## # ## #### # ###      #
#      ###               # ##   # ##    #  #######     ## ######   ##  #  ####    ## ## #  ###  # ## #  # # #       #     ## ###
### ##     # # ## ##### ##  ###    ## # ## # # #   # ###    ##   ###  ## ##  ## ####  # # ## ## # ## # ##     #####   ##########
#   #  # # ########      # ## # ## #### #  # # #####   ### ##### # # ##  ### ##    ##              # # #  ###     ###       ## #
###### ### ## ## ####### # ## ####  ##  ##   #  # #  ####     ##     ###  #     ####### ############ # # ############# # ##  # #
#  # # #####      # # ##   ## ## ## ### ## ### ## ## ## ## ## ## ### # ## ### #### ## # #   ##               ###  # ########## #
## # # #     # ##      # #        # #       ## #  ## ## ####  #####    ##  ## ## # ##     ###  ###### # ## ###   ## # # # ###  #
#    ##### #####  ## #   ## ## ##     # # #  # # ##  #  # #  ## # ## ###  ###       ## ##   # ## ######  ####  #      # # # ## #
#### ##  #### ###  ##### ## #  ## ## ## # ## # # ### ## # ## ##      # ## #   ## # ##   #####         ######  ### ##### # # ## #
#    ### ## # # #####    ## # ##  ##  # ###    # # # ##   #  ####### # #  ## ######### ### ## #### ######  ## ##### # #      # #
## #             ###  # ### #  ## ## ##  ##### #   #  ### ##  ## ##  # ## ## ## # ## #     ##   #### ## ##  #  # ##     ###### #
######## ### # #     ## #   # ### #  #  ##     ###   ##   ## ##  ### # ##  #  # #    ## ####  ### ## ## ### # ##  ### ####  ## #
# #      #   ### ## ######### # # ## ## ### ##     #  ### ##  # ##      ## # ## # ####   # ## # # ##  # #        ##      ##  # #
# #### # # # #   #### ##   #### ######   ###### # ### # #  # ## ## #### ## #  # # ##   #    # #   ## ## # ########### ##### ## #
#   ########### ## ## ####  ##   ##    ### #  ##### #   ## #     #####  #    ##    ## #######   ###   #      # ## ##     #     #
### # # # # #####      # ## #  ####### #     ### ## ### ## ### ##### ## ## ###  #####    ##   #   ## ## ####    # ### #### ## ##
### #   # #  # #######        ###      ## ##  #   # #      # #   # #     # # # ## #   ##### #######   # ## ######      ##   ####
#   ### # ## # # ########### ## ######  #####   #   ## ### # # ### ## ##        #   ###           # #    #  ## ### # ###  #  # #
### # # # #                # ##  ## ## ###  ## ## #  ####  # # # # ####  # ## ### ###### ###### # ### ##   ### # # ###   ###   #
#     #   ############# ## # ## ##  #####  #####  ## ## ## # # # #  ##  ####   ##  #       #########  ### ## #      ## ### # ###
#####   #         ##    #     # ## ## # ##  #    ### ## ## # # # # ####  ##### #  ## #######   # # ##  ##### # ####        # ###
#   #############    #### ###    # #  # ### ### ###  #   # #       # ## ## ### ##     ## ##  ###   #  ## ##      ## ## # ##### #
# # ##  ### # #   #### ######## ## # ## # # # ### ## ### # ## ## # # #   # # #### ######  # ## ###   ###    ## # ## ## #### ## #
### ## ##       ###    #      # ## #  # # # # ##         #  ###### # # ### #  ##     # ##        ## ## # ################ # ## #
##     ###############   # ##    # ##         #  # # ### # ###  #    #  ## # ##  ##### #  ######### ##      # # # ### ##       #
#  ###  ##   ###  ## ## ####### ##    # ##### ## # # #       ## ####   ###    ## #  #  ##  # #  # # #  # #### #          ## ## #
##   ##  ###     ##   ### # ##   #### ###     ######### ### ##  # ####     # ### # ## ##  ## # ##     ####### # ##### # ########
#  #####   ### #  # ###     ### #######   # #   # # # ###   ### #  ##  #######   # #   ## ##      # #   ##  # # # ########    ##
###### ###     ##   # ##### # #     ### # ##### # #   #####     # #### ## ##### ## # # ##    ############# ## #      # # # ##  #
#### # #   ## ##### # #   # # ### ### ######    # # ###  ### ##     ##  #  # ##  # # ###### ##  ###  ### #      ###### # #  ####
#    # ######## #       #          #  ## ##  ##   #  ###     ##### ##  ## ## ### #    ## #     ## ## # #   ## ### # ## # # #####
#### # ## # #     ## # ### # # # #   ##     ##### ##  #### # # #    ## ##  # #     ##### ## ####         #  #       ##         #
#             # # #  ####### ###### ######### ##     ## ###### ## #### ## ## # ###  ## # ## #    # #### ### #########  #########
# # ## # ###### ####### # ##### #    # # # ## #  ###      # #  #   # # ##        ####         # #########       #     ##    # ##
### #  # # # ##### ##           #### # # # ## ######### #   ## ### # # ## #### #### ## ########         ### # #   # #    ####  #
#   # #### # # ##   #### # # ##      # # # ## # ##  #######            #    ####  # #        ### # ## #   # # # # # # ##  # # ##
## #### #         #  ##  # #  ### ##             ##       # ## # # ###   # ## ###     # ## #  ## #  ########### # ###  # ##    #
####      # ########    ## # ###  #  # # # # # #  ####### ######## #### ##### # # #####  ####  ######  ### # ####  ######## ####
# ###########   ##   # ########  ## ## ########## #        #    ####    # # # # #    ###    ##  ##  ## # # #  ######           #
#          ####    # ###  # #   ##   ####   # #   ### #### ####      ##           #### # ######  ## ##     ##   ##   ## # ## ###
#### ##### # #  # ## #### # ### ## ###    #   ###  ##### # #  ## # ##### # # # ## ###  #### # ##     # #####  #    ###### ##   #
# ######   #   ## #  #      #   ##   ######## # ## # #     # ########    ##### #      ####     ## ##     #   ## # #### ##  # # #
# # ## ###   #  ###########   # #### ###               ###    # # #   ##  # ##### # #    # #####  ### # ## #### #      ## #### #
# # #      ### #### # #  ### #### #### ######## ## ## ###  ##       #####    ## ###### #    ## #### # #     # # ## ## ##    ## #
#     # #####  ## # # ##     ##     #   ###     #  ## #   ##  # ## ##     ##      ####### #  # # #  ### # #   # ## ###### # ## #
# # # ##### ####         # # ## ### ###     # # ######## #### # ##  #### ### # ##   # # ####       ###### # # # ##      # #  # #
# ######     ########## ##########  ##### # #######    ### ## ##### #      # #  # #        #######  # ##  ######### ########## #
# #      ###   ##       #   # ## ##       #####     ##         ##   #### ### ## # ## ########## #####  ##    # #  # #### ##### #
############## ###### ##### # #     # ## ##     # # ### ##### ##  # #     ##  ###  #       #          ######## # ##       #  # #
###     #             ##        # # # ###### # ## #  #####    ### ##### #  # ##   ### # ##   ## # ##### ###       ## ## #   ## #
#   ### ### # ##### ######## # ## ##### ## ########### # ####   ###     # ##  ### # # #### # ####           # # #### #  ###  # #
# # #       # ##    ##       # ## #                           # ##  # # #  # ##     #    # #    # ## # # # ## #    # ##   # ## #
############################################################################################################################## #
