# ########################################################################################
#  # ## ##  ## #  # ##  #  ## # # # # #       # #  ## ##   ##  ## ##   ##   ##  # ## ## ##
## # ##    ##  ## # ## ## ###   # # # # ####### # ##  #  ###  ##   ## ### #####    # #   #
#    ### #####              # ### # # # ## ## # #  ## # ## # ### ###  # # # # # ##     # #
####  ##  ## # #### ######### # # #               ### # ##         # ## # #     ### ## # #
# ###  ##  # #####  ####  ##        ############### #      ### # #          ###   #  # # #
#     ##  ## ##  ##    # ##  ########    #### # ##  ## ###  ## ### ###### ###### ## #### #
##### ## ##   ## ## #### ## ## # ##   # ##  #    ##  # #############   ######  ####   ####
#     ##  ### ## #   ##  ##  # # #  ###### ## ######             ##  ### #  # ### ## ##  #
### ###  ##   ## # #### ####       ##  # # #    ##   ############### ##  # ##      #### ##
# #   ##  ### ## # ##   # #  #########     # #######        # # # #  ## ## ## ########   #
# ## ##  ## # ## #  ### # ## #         # ### ##  ##  ##### ##   # # ### #       #  # ## ##
# #   # ### # #  # ## #        ### ## ## ###  # ##  ## # ###  # # # #     ### #   ## ##  #
# # ### # # # ## #    ## ### #   #  #### # ##    ## #     #  ####     ##############  ## #
# #  ## # # #  #   ##### ####### ##  # ### #  #####   ##### ## #  # #  ##    # ###   ### #
# # ##    # ## # #####        ######    ## # ## ##  ####  # ## # ######## ####     ###   #
#    # ##    # # # # # # # # ## # ## #####       ## ## ## #        # # #       ##### ## ##
### ##### # ## # #     #######  # #####  ## # ##     #  #   ##### ## # # ### #  # #  ##  #
#   # # ### ##     ###### # ## ##  ## ##  # #### ## ## ## ### ###### # # ### ##     ##  ##
### # #  #     ###          #  ## ##  ## ##  # #######      # # ##   # #   #  ## ## ## ###
# #   ## ## #### # ## # ##### ##  #  ##  ## ## ## ###  # # ##    ###     #############   #
# ### ## ## #    #  # #   ##  ## ## ### ### #   # # # ######## ### # ###     ## #  ##  # #
# ### ##      # ####### ##### ##      # # # # ### #    ######   ## #   ########   ##  ## #
# # # ## ########     # ##    ## ### ## #       #   #### # #  #      #### # # ## ### ##  #
#     ##    ## ## # ######## ##    ####   ####### ### #  # # ## ## #   #  # #  #      ####
#####  ### ##   # ###  # # # ### #####  #  ###          ## # ####### # # ## # ## ####   ##
#  ## ###   ## ##  ## ## # #           ###     ##### # ##     ## ####### ##         # #  #
## #  # ###  #  # ###  # # # # ## ### ##   ###    ## #    # #  #    # #     ############ #
#    ## # # ## ## # # ##   # ##########  #  ## # ###### ### ##   ##     ###    #### ###  #
#### ##        #    # ### ##    ##    #### ##  ###  # #   ###  #  ## ##   # ##        ####
###   #### ###   #### # # ## ##### #### ######   ## # ###  ## #####   ## ##  # # ### #####
# ###  ##   ###### ##      # #  #  # #   ## #  #        ##  #     # #### ## ## #   #     #
#  ## ##  #  ## ## ## # ####   ## ##   #    # ## ########## ### ###### ###   #### ## # ###
## ## ## ###       ## ####   #  #    ###### # #           #####         ## #### #  #######
#  #  ## # ## ######   # # ####   ##      # # # # ## # #####  # # # ## ##       ##  # ## #
## # ##     ### # ## ### #    ######### ### # # # ## #       ## # ####  ##### #### ## ## #
## #    ## ####   ##  ## # ######## # ######### #  ### ## # ######## #### ###### #       #
#    # ###### # #####        ##           ## ########  ####    # ##  ## #   ##   # #### ##
# ####    #   #    ## ######### ###########  # # ## ##   ## #### #  ###   #    # #  ##   #
#  # ###### ### ##### ####### #         ### ## #  # ## ####### # # ## # ###########  # # #
## #     ## ### ## #            ## ## #   # ## # ## ###### #   #        ## ###    ## # # #
#    #####       # # ####### # ##########   ## # ##    # # # ### # ####        ###########
## ####### ## ##     ##    ######## ## ####         #### # # # # ### ### #######  # ### ##
#           #  ## ##    ##      ##      #### # #### # #           ## # #       ##    #   #
## ## # ### # ##  #### #### #####  ####    ###   ####   #### ####      ##### #    ##   ###
#   # #######  ##   ## ######## ## # ## ##   ##### #  #   ##    # # ## ### ########  #####
# # #       # ### #  #  ## #     #   ###########   # ### #### #####  #      # ### #####  #
### ## ## ### ##  # ###      ###   ### # ##      #    #####      ## ## ## ### # #  ## # ##
#   ##  #   ##### #   ## # #######        ## ## #####  ## ### ##### ## ## ### # # ##  #  #
### #  ## ###  #  # #  # #     ##### # ##     #     ##      # ### ######          #  ## ##
#   # ##   ###   #### ## ## ##     ###### ############# # ###          ## ## ## ### ### ##
##### ## #  ## #    # ##  ##### ##### ##       #     ## ###### # ### # ## ##  #  #   #   #
#  ##  # ##  # # ########    ##        ## ## ### ########## ####   ######  ## ##   #   # #
##    ##  # ## #        ## #  # # ## #  # ##  ## # # # ##      # #      ## ## ## # # #####
#  # ##  ##  # # ## # ###  # ## #  ### ##  ##    #   #    ########### #  ###   # ###     #
## ######## ## # ## #  ##### ## # #### ## ##  ##   ### ######   #  #####   ### #  ## # # #
#     ##  ########  ##     #### #    #  #  ##  ## ## #        # # ## # ########## ## # ###
# # #  ##  #   ##  #### ##  ##  ## ###### ####  #      ##########       # ## ## #  # #   #
# # ##  ##   ########    ##  ####      ####### #######  ## #   ## ### # #  # ## # #### # #
# #####    #    # ##  # ####   ### # #     ##        ## #    ###   ###### ## #  #   ######
#     ## # # ##    # ##   ## #  ## # # ## #### # # ###    ####   ###   ##      ## #      #
## # ##  # # ## ######  # #  # ##### #  #  ##  # #  ## # ##### ##### ###  # # ##### ## ###
#  ##### # ####   # ######## #   ##  # ## ###### ##  ###                 ## #     # #### #
##     # #####  #    #     ######### #  #     ## ## ##   ## ## # ## # ####  ## # ##   #  #
### # ##   # ## # # ## ######    ##  ##### # ### #  ## #  #  # #  # #   ### #  ######   ##
#   # ## #    ### #           ##  ##    ## #   #### #  ## ## ###### # #  #####      ## ###
### ###  ## ####  # ## # # ##### #### ###  # #### # # ##  ##      ### ##   ##  ### ##    #
#   ##  ##     # ####### #  ## #  ##  #### #      # #  ###### #########  #  # ######## # #
# # ## #### ####       ### ##  ##  ## # #  ##### ## ##   ## #         # ########     #####
# # ## ####    # ## ##  ##    ##  ###   ##    ######### ### # #########   ## ##  # # ## ##
# ###   ##  ## #  #  # #### #  ##   # #### # ## ## # ## ##           ### ##     ######   #
###### ####  ### ### ### #  # #######    # #         ## ## ## # # #### #### ####### #  # #
#       ##  ##    #####  # ##       ###### ## ## # #### #  ## #######   ##    ## #    ####
#### # ##  ### ##     ##    ## # ##  # # #########    # ## #          #  # ####    #### ##
#    ###  ##    # # # ### ###  #####      # ### #  # ##### # # # ###### ##  ### ######   #
#### ####  # # ## # #  ##   # ##     ####   #   # ##   # ##### #     ##    ## #  ##    # #
##     ## ## ###  # # ##  ###  # # #   ## #   ##########  # ## ## # ### ##      ##  ######
#  # #  # ##  ##### #  ##   # #### # #  # ## ## ###      ##     ###   # ### # #  ##    ###
## # # ######  ###  # ##  ### # #### #### ##        ## #  ### #   ## ## #   ####    ##   #
## ###   #  ##   #### ## ####    ##     #### # # # ###### ##  ########  ###   ## #########
#    # #   ##  #   ## #     ## #  ## ## ## # # # #  # #    ##        ####   #  #     ### #
## ### ## #### ## ##  # # #  # # ###  #    ### # #### # # ### # ## #    # ### ## # #     #
#   ##  #   ## ##  ## # # ## #####   #### #### #  # # ######  #  ##### ##  ##  ### # # ###
## ### ## #  ###  ##  #####      ### #  #    ####      # # ## ##     # ## ####   ### #   #
#  ##   # # #####  ##   ### ## # ##    ## ##  # # # ##     ## ## # # ###    ## #  ## # # #
##  ## ####  # ###  ###   #  # # #  # ##   ##   ###  # # #  ########   # # ##  ####  #####
#  ##     ##   # ##  ## ######## ## ###  #### ###### # ####   # # ## ##### ###  # ########
##  # ## ##  # #    ##         # #   ######        ###   ## #      #    #### ##        # #
#  ## ## ##### ### ##  #### ## # # #    ##  ## ## ##   ###### ## ######## ##    # ## #   #
## ## ##    ###### ###    ###### # # ##  ##  #  ######    ##  ## ## #     ## # ##  # # ###
## ## ## ####        ## #      # # # ####### ##  # #### ##### ##      ## ##### ## ## #   #
#   ###     # # # ## ###### # ## ###   ## ##  ##     ##     #  ## #####    ##   # ## # ###
## ##   ## ## ### ##      # #  # #####    #####  ## ### # # # ##      # # #### ##  # #   #
###### ###### #   ### # # # # ##    #####     ##  # # ### # ###### ######## #  ## ## # ###
#      #    #####   ### # # #  # # ## #### ####  ## #   # #  ##      # # ## ######## #   #
#### #   # ####   #  ## # # # ## #       #   ## ##    ###### ## ## #          ## # #### ##
#    # ### #    # # ####### # ## # ## # ### ##   ## #    ##  ## ## ##### # ##        ##  #
# # ##   # ### ## #    #  # # ## #  # #   # #### ## ## #  ##  # ##     ####### # ####### #
# #  ## ## ##   # # ##   ## #  # # ## # # #  ##  ##  # # ##  ##  ## ##     ##  #       # #
######################################################################################## #
