# #############################################################################################################################################
# # #   # ## ## # # ##      ## # ## #          ##  ## # ## # # # # ## #    # ## ## #  # ## # # #    # # # # ## ## ## #              #  # # # ##
# # ###      #    #    ## #  # #      ## # # # ## ##           # # ## #### # #   # ## #  #   # ####     #    #     # # #### ######### ## # #  #
# #  #  #### ####   # ##  ## # ###### ## # # #  # ## ###### ##     ## ###      #      ##   #   ## ##### #### #### ## #    ####   ##   #      ##
# ##   ####   # ### ##### #     # ###  ######## #  ####   ###### #### # ### # ### # #  ####### #  ##          #   ## # ##### # ######   # ##  #
#    ####   #   ### ##  ### # #       ##  # #   # ##  ### ## ##   ##     ############# #  #    ## #  # ###### ### #      # # # ## # ## ####  ##
########  #####      ## #   #### # ## ### # # #    ## ##      # #  ### #  ##   #   #   ## ####    #### #            ###### # #  # # ##   ######
#  ### ## #     ## # ##   # #  ########       ## #     ##### #####   ####  ### ### ## ### ## #### # ######## # #### # ## # # # ##      #    # #
## # # ###### # #  #  ## #####  #  ##   # ## ######### ## ##  ## ### ## ## # #         #      ##    # #      # #         # # #  ## ########## #
#    # # ##   #### ## ## #   ##   #############   #       ### #  ##   # ##   #### #### ######    ## # ## ## ####### ###### # # ##    ## # # # #
# ##      ## ### ###   ##### #### # # #### ## ### ## ## #   # # ##### # ### ####  ##      ###### #    ##### ##       ## #    # ### ###        #
#########  ### # ### #### #         # # #      #     ## # #      ##         #  ###### ### # # ####### # #    ## ####      ####  #      ## # ###
### #  ###  ## # # ### #    ### # #   # ###### ## ## ## ##### ## #  ####### # ## # #  #       # ##    # #### ## #    ####   ## ## ## #  # #####
# # # ## ##  # # #  #    #####  ### #              ####### ## #    ###         # #   ######## # #  ## # # ######## #    # # #   # ########### #
# #       # ## # ## #### #   ######## ## ###### ## #  ##      ## #   ######### # ##### ###        ##    # # # ## ### ######   #    ## #     # #
#   # # #      # #    ######  ##  ### #  #      #####    # # ##  ## ##           # ###   ### # ##  ## #                 #### #####      ###   #
### # #### # # # #### # # #  #### # ######## #### ##  ## # # ### ####  ## # #### # # ###  ############# # ### ## ### ##   ##     # ### ###  # #
#   ###    ###    # # # # ## # #    ## ########## #  ##  # # # ### ## #########       ## ## # # #   #   # #   ######  ## ##  ## ##   #   #### #
###  ##### #   ##            # #### #  # #          #### # # # ##   # ## #      #### ##         ### ### ### # #      ###### ##   # # # #    ###
### ##     ### ### ## ### ##    # # ## # # ## # # #    ####### #### #### ##########     # # # #   # ##   ## # ## # #  ### ##### ## ###### #   #
#   ### # ###   ##  ###   ## ##   #      ######## ## #### # #    ## ##   # # ###  ### ### #######   #  # ## # #  # ##  #      #  #    # #######
# #  ## # #   # #  ###### #  #  #   ## # ##### #  #### #  # ####    ####     # ## ### ###### # ####   ##  ### ## #  ##   # ## ## ## #   ## ####
### ######## #### ##   #  ## ##### ##### # ##    ##    ## # ## #### #  #####        # #          ## # #  #### #### #### #######   #####       #
#   ## #  #### ####### ## #  ##    #       ###########          #   # ## ### # ####   ## ## # ##    # ##    ### ## #       #  # #     ## ## ###
###### # ## #   ## # #  ######  # ## # # #    # # #  ###### ###   #   #      # #    # #  #  #  ######### #####     # # # #   ##### # ##   #####
####        ### #  # ##  ##  ########### # ##     # ## ##   #   # # #   ### ## ## # # #### #####             #### ## # # ###   # ########     #
#  ########  ## ## #  ## ## ## ##  #     #### ### # #   ####### ### ### #   ## ## # # #    # ####### ## # ## #    #  ###   # ###  # # # #######
##  ##### ## ## ## # ##     #   ## ######## ### # #   #         ##  ##  # # ####  # ### ####         ## ####### # ## #   ####### ## #      ####
###        # ## ## # #  # # ## ##  ##  ##    #      # # # #### ##  ### #### #    ####   ##   ##### # ##    ## # ###  # # ## ## #      ### ##  #
# ######## # #     # # #### ## ### ###    ##   ## # # #####    ### ##    ## ## #    ###  ### ##    ###  # ##     ### ###         ## # ###### ##
# ##           # #   ####          # #### #  #  ######## ## #### ###  # ###### ###############  ##  ## ## ### ## #   ### ## ### ### #    #    #
#    ### # # ### ### ## ######### ## #  #### ## ## # # #  ###### #### #   ##    ###            #### ##  ###   ###### #   ##  #####  # ##   ## #
#### #   ######   ## ##  ###    # ## # ##  ######    # ## ##   # #    # ###### ## ############   ## ## ########      ## #### # # ####  ## ##  #
# ######### # ## ##   ## # # ##      # ###  # ###### #  # #### #   ## ###  ### #  # # # # #    #  # #  ## ##    ## #  # ##          ##  ###  ##
#  ###         ###### #  # ###### ##   # ## #    # # ##    # # ### ##  ## ##   ##           # ## ##### ##    ## ## ## # #### # ################
##     # ##### ##     ## # ##     #  #        ##      ####     # # ### ##    ##### #### # # # ##   ##   #### ## #   ###  ##  #          # # # #
##### #####     #####         ## ## ##### # ##### ## ###   ###     # ##### ##### ###    # # #  ## #### ###   ## ### ##  ##  ## # # ## #       #
#     # #   # #       # # # #  #### ##    #####   #      #  ## # #    ## ###   # ### # ## ### ##   # ####  #  # ### #  #### ## # # ## # ## # ##
##### #   # ##### # # # ### # ### #  ######## ####### ## ## ## #### #  # ##  # # #   # #  #   ## #   ## # ## ####   ## ##   ## # # ## #### ####
#  #  ##### #     ### # #   ###     ## #      #####   ## ## #   # # #### #  ##     # # ## # #  # ## ##    ##  ##  # ## #  #  # ### ##    #    #
## # ####   ## # ##   ### # ###### ##    # ##     ## ##  #  # # #   #      ##  ### # ###### ## ###  #  ##  ###### ######### ####   ## # #######
#    #    # #  #  # # ##  # #      ## # ## ## ###    ## ### ### # # ##### ####  ## ####     #  #### ######  ##    #  ## ##    ## #  # #       #
### ## # ## ##### ################  ######  ####  # ######  ##  # # #     #  #########  ## ###    # #      ##### ###       # ##  # ## ## # ## #
#   #  ###  ###   ## ## ## # ### ##### #   ##    ## ##     #### # # # # # ##           ##  ##  #### #### # ##    ##  # ## ###### #  ###  #  # #
# ### ##   ##   # #            #  ##     # ## ## ##  # # #    ############## ##### # # ### ###    # ##   #  ### ###### ##      # ## #   ## ## #
#####  ###  ## ## # # ### # ##   #########  ######## ### # ####    # # # # # ##    # ###    ### # ##### ### #   #       ## # ### #  # #  ######
##    ##   #####  ############## # ## ###  ### ### #   ##### #####         # ### ###  ## # ## # #####    #### # ### ###  # #  ##### ### #### ##
#  ## #  #### #  ### #   # # #     #      ###        #####    ###  #### ##   #   ### ##  # ##   ### ## ### #### ##  #   ## ##    ## #         #
######## ###  ####     #   # #####   ### ##   ### ##  ## ### ## ######  #  ### ###    ## ###  #      # # #      ###### ### #####  ### # ## # ##
# # ## ### ## ###### #####         # ###  ## ##    ####  ### #  # #    ###  ##  ### ######### ## ####### ########      # #     # ###  #  ### ##
#      ##            ## ###### ## ####   ##   ### ##  ## # # ## # ## #  ###  ##   #### #   ## ##    # ## # ###### ## #   ## ###### ## # ##    #
##### ######## # # ####  ###    #####  # ## #########                ####   ##  #### # ###    ### #   ##          #  ## ###        ######## # #
#     ## ##### ###### ## #   ##### #  ## ####    ## ## # # # ## ## #    ###  ## # #        ##   ### ###### # ## # ##### # ###### #    ##    # #
#####          ##          #  ## #   ##  #    ##  # ## # # ###   ### ## ##  ##### ######## ## #  ##  ##    # ## # ##         ##### ## ## # ## #
#     # ## # # ######## ## ####    ###  #########      ### #   # #   ## ## ## ##            # ## ## #### # #  ########## ###     ####  # #  # #
# ## ## ## ### #        #  ############## ## # #######  ###### # ## #####  #   ## ## #### ### ##  # ##   # # ####  # #    ### ##### ###### ## #
#### #  ######## ## ### ## #   ##### # #     # # ##### ##  ### ######     ## #    #  #      # #  ##  ### # #### ##     ##  ####         ##  ###
#    #### ## #####  ##  ## # #           # #   #          ##      #### # ######## ## ## # # # ##  ####   # ##      ###  ##      # # ## ####   #
# # ## ##    # ##  ### ##  #### ## ## # ## ###   ## ## # ##### # ## ###### #      ## #  ### #  ##   ### ## ##### # #   ### # # ####  #    ## ##
###### ##### # #  ##   #  ##    #  #### ####### ##  #  # #     # ## #  ### ##### ##  ## #   ## ## #  ##  ###     # # #   ### # # ###### # ##  #
## # #  ###      ##  ####  ## # ##   ## # ## #  #  ### #### # ## ## # ## # ##    ### #  # # ## ## ############# ## ### # ##  #       ##########
#    # ##   ####  ##### ## ## ###  ###  #      ### #    ##  #  ###            ## #   ## ### #  ##  # ##         ####   #  ## # ####### #  #   #
## #      #   ### # #    #########   # ## # ## # ### # #### # ##   # ## # # #  ######## ##  ## ###    ###### ## #    # ####  #     #     ## ###
##### ### # ### ### # ######       # ###  # #    #####  ##  # #### #  ### # #####        ##  #   ## ###      #  ### ##    #### # ### ###  #   #
# # ##### ##### #     # ## ###### ## ### ## ## ###     #### #   #### ##   #### #  ## # #### ####### ### ## ### ##    ## #   ####       ##   ###
#   #   ###   # ##### # #          ### #### #   ##### ####### ###    ######      ##  ####     # ##  #   ## #   #  # ##  ###    # # # #### #   #
###   #   ## ## # # # # ## ## # # ##        # #  ##     ## #  #   ####  ########  ## #    # #    ## # #  # ## ### #  ##  ## # ## # #    # ## ##
######## ###               #  # #  #### # # # # ##  # # ## # ## # ##### # # #### ##### ## # ## #### # ## # ## #   ####  ### #  ### ############
#            ## ## # # ### # ########   # # ###  #### ####   #  # #   #           ##    # # #  ##   # ## ####### ##    ##   ####    # # ## ## #
# # # ### # ##  #  # # ##  ##### ## ## ## # #   ##     ##  # # ######   ####### # ## # ## #### #  # #  ###       ### #  ###   #### ##         #
### ##### ##### ## # #  #######         # # ## #### ##  ## # #    #### ##       # #  # ## #    ## # # ##########  ## # ## # #  ##     # # #####
#   ##    ##    ############ #  # # ### ### #    ##  ####  # ######    ## ### # ### ##  # # # ##  # # #          ##  #    # ##  ### #####   # #
# # ## # ##### ## # # ###    # #### ##   ## # # ##  ##########      ## ## #   #  ## ## #### #  ## # #### # # ## ##  ## # ##### ####    ## #   #
# # #### ## ####          ##     ## ## # ## # #  #####  # ##   # ## ##  ##### # ##   # ##   ## ## ####   #####  ###  # #     #### ######  # # #
#####    ##  #   # # # # #### ## #   # #  ### #### # ##    ## ## #   # ##     ###  # # ## # ## #  ##   #  # ##### # #### ###           ## # # #
## ### #  ##   # # # # ###     # ## ##### ##  #       #### ##### ## #########   ## # # ## #### ## #  # ####            #   ##### ## ##### ### #
#    # ####  # ### # #  ### # #######   # #  ## # # #  # # # #   #   ## # # # ##########   ##   # ## ############## ## # # ##     ######    # #
# ##   ##   ## #   # ##  ####   ##    #   ## #  # # ##         # ## ##             ##    ##### ##  #####  ### #      # # # ### # ###   ## # # #
###  #  ### #  ### # #  ## ## ##### # # # ##### # # #### # ## ## ## ## ## # # ####### ##  ##   #######   ##     # ## # # #   ###     #### # # #
#   ## #### ## ###########      ##  ### #  ##   # ### #  ####  #  ####  ### #       #### ##### # # #   #  # # ### ## ### ###   # # #  # # # ###
### #  ##   ## #  # ####   ## #####  ## ####  # # ##    ##    ## ##    ####### ## # ##    # ## # #   # ##   # ##   #  ##  ## # # ### ## ### ###
#   ##  # #  ####    #   ###    # ####  ## # ##########  ## #  ##### # ##      ## # #  # ##      # ######## #  ## #####  ##  # # #####    #   #
###  ## ####### #### ###   ## #    ### ##  #   ##  ## ####  # ### #### #  # ##  # # # ##  ## # # ###     ## ## #      ##  # ## #       #### # #
#   ##  ## #     #       #### ## # #    ##   #####         ## ##  # #  # ## #  ## ###  ##  ##### ##### #     # ## #####  ## #### # # #    # # #
########## #####   # # #    #### ### # ##  #   # ##### # # ##  ##     ## #  ##  #  ## ############ # #### # ## ##     ##  #  ### ### # # ## # #
## #         #   ### #### ####    ########### ## ##### ###  # ##  ###  #### ### ## ## ## ### # ##     ##  # ##  ## # #### # ##     ########## #
#    ### # #   # ##  #    ##   # ## # # ### ###  #     ##  ## ## ##   ##      ###   ###        ###### ### # ## ##  # # #  #  ## # ### # # #####
# # ##   ##### # ### ## #  ### #    # # # #  ### #### #### ##  #  ### ##### #   ### ##########            # ##  ####   ## # ##  #             #
####### ##     #  ## ## ##  ## # # ## # # ##       ## # #  #  ### ##  #     ## ##   #  # # # ## ## ## ### #  # ##### #### # ## ## #### ## #####
#        ### # ##  #### ## ##  ### #      ###### #      # ## ############ # ##  ### ##          ####    # # ####        # ######     ####   ###
##### ######## ## ###    ##### #   ## # #        ## # # # #   ## #   # ## ###  ########## ## ##   #### ####   #### # #### ## ##  # #### ##### #
#     ## # #   #### ## #   ##  ###### # ## ## ## #  # # ### # #    #        ## ## ##       ##### ## #    ## # # ## #  ###    ## ## ##         #
## ##### #   #   ##    # #####  ##    # ## #  ##### ### ##  # # ###### ####  #### #  # # #### ##### # # ### ###    ##   # ## #  ##    # # #####
#  #       # # # ## # ##   # ####  ## # #### ##      ##  ## #####       ##  ##      ####### # # ##    ### ###### # #  # #  ### ##  # ## #     #
## # ####### ### ## # #  ### #    ##  # #    ## # ##  ####  ## #### ## #### ### # ###            ## #  ## ###    # ## # ## ##   ## #  # # ## ##
#  # #       ##  ## ### ##     # ##  ####### ## # ### #    ###       # # #   ## ################ ## ##      ## # ###  # ##### # #  # ######   #
# ####### # #### #  ##   ## ## # #  ## #     ## #  ## # ## #   ### # ###   ######   ## #             ## # #  ###   ## #     # # ## #      ## ##
#####     #    # # #### ###### # ## ## ##### #  # ##  #  # ######  #  ## #### #####    ## # # ## # # ## # # ##   # ## ## # ## # ## ## # ####  #
## #  ### # # ## #  ##   ##  # # #  ##       ## # ### ######      ## ##  #          ##    ### #  # #  # # # ## # #  #  # # ## # ##### #    ## #
#    ##   # # ## ####  #####   ######## # # ##  ###      ##  # # ##   ###### ## ## #### #  ## # ## ## # # # ## ### ## ## #  # # #     # ## #  #
######## ## ####  ######     #  ##      # # ###   ## ## ######## ### ##       ####### # ## ## ###   ### # # #   ## ####  # ######## # #  # ## #
##    #   ###    ## ######## # ##### ######## # ###   # ##        ## #  # # # #         ## ## #   # ### ### ## ##     ## # # # # ## ### ####  #
#  ## ## #### # ##           ### #######         ### ##  ## ### # ## #### # # # # #####  #  #### ##   #   # ## #  # ######        #   # ##   ##
####        ###  ## # # ### ##           # # # #   ###  #####   # ####    # #######     #####    ### ## # # ## ## #  ##    ### # ## ###  ## ###
###### ## #   ##  ##### ##   ## # ##### ## ##### # ##  ## #### ##  #### # #  ##     # #  ##   ## #    # ### ####### ##### #########   ## #    #
#   ## #  # # ## ### #  #  ###  ###     ## #  ## ######## #     #### #  # ## ## ##### # #######  # # ## ##    ## #    ##   # ## # # ####### ###
###    ## ### #  ##    ### #### #### # ######     ## ## # # # # #      ## ## ## #     # #  ###  ## # ##  ## # ##   # ##  #        #     # #   #
### ## #    # ##  ###### ### #  #    # ##   # # ###         # # ### ##  ###   ##### ######     ##  # ## ##  #  # # #  ## # ## # #### # ## # # #
#   ## ## ### #####       ##   #### ##  ###   #   ## ### # ## ###   ## ##   # ###   #      ## ### ## ##  ## ## ### ##  # ###  #   ####    ### #
### ## ## #####     # # #    ### ##  # ###### # # #  #   # ## #   # ## ## # ###   # ## # #  ###    # ## ##   # #   #  ##  ## ## #    ## #  ## #
#   ## #    ##  # # ###### ###      ## ##     # ####### ## ## ##### ##  ### ####### #  # ## ##  # ####  #  # # # ####  # #####  ## #  ####  # #
###  ### ## #  #### ##       #### # ## #  # # # ## ## #  # ## #     #  ##   #       #### ##### ##    #### ## # ###    ##     ## ## ##### ## # #
### ###   # # ##     ## ## #####  #  ###### # ###       ####  ### # ## ## ###########     ##   #  #######  # ####  ## ## ###  # ##    #  ## ###
#   ##  # # #### ## ##  #  ##    ###  ## #  # ##  # # #  ### ##   # ## ## ##          # # ## # ## ## #  # ## ##   ##  #    # ## ## ##   ##    #
# #### #######   #  ###### #####   # ##    ###### # ####   # #### # ## ## #### ### # ## # #  # #       #######  #  ## ## # #### #   ###  # ####
# #  # # # ##  # ## #      #     # #  ### ##      #### # #####    # ## #### ## ### # #  #### # # # # #   # ### ### ## #  #### #### ##   ##    #
# ##       #####  #### # # # # # #### #   ##### # ##       ##  ## ###  #     # #   #### ##   # # # # # #     # ##  #####         #  ## #### ###
# ## # # #   ##  ##    # # # # #    # # #  ##   # #  # ## ##  ##   ## ## # #   ## ##    ## # # # # # # # # # #  ##  ##   # # # # # ##     #   #
############################################################################################################################################# #
