# #############################################################################################################################################
#  # ## ##  # # # ## # ##   ## #  # # #        ## # # # #         ##    ## # #  # ##  #  ## # #  ## ## #      # # ##     # #        ## # ##   #
## # ##  ## #     ## # #  ###    ## # ######## ## # #     ## ####  #### ##     ##  ## # ##    # ##     ### #### #  #### ## ## # # ###  #  # ###
#     ## ## #####      ## # ## ####       # ## ##   #### ###### ## # ##  #### ### ##     ## ### #### #      # # ##  ##  #  ## ######  ## ## # #
## ## #  ##  # #######            #######       ### # ####  ##   # # ### ##   # #  ## ####      # ######### # # #  ##  ## ###    # ##     # # #
#####   ####    ### ######## ## # ### #### ## #        ####    #     # # #### # ## ##  ##  #### #  ## # #         ##  ##  # # #### ## ## ##   #
# # ## ##  #### # # # # ###  ## # #      ############ ##  ## # ## ## # # #       #  ##  ## # ##   ##    ### ## ####  ####       ##  # ##### ###
#         ## ##     #     ##### ######## ## ##         ## #########        ## ## # #### #     ######### ##  ##### ## # ## # # #    ##  ## # # #
## #### ###  ###### ##### ###    ## #       ######### ##   ## # ####### # ##  #  #  ##  # ######### #    ## # # #    # ## ########### ##    # #
#  #    ##  ## ##         #   ## #  # #####  ##   ##   ### ## # # # ##  # #  ### ##  ##    ###    # #### ## #   ## ### #   # # ## ##   ### ## #
####### ## ### ###### ### ### ##### ### # ## ####    #     ## #   # ##########      #### ### #### # ##   ##   ###  # #   ###    # #  ### # #  #
### # # #  # # # #  ####  ##   ###  ##          #### ##### #  ###       ### ##### #   ##      # #    ### #  ### ## # # #     #### # ####   ## #
# #     ## #   # # ### ##  ## ## ##  ########## ## #### ## # ## #### ####    # ######  # ### ##   # ##     ##   ## #   # # # ###    #  # # ## #
# ##### ## # ### # ##   ## #  ## ### ##  #   #      ##            ##    ## #    ## ## ## ##########  #####  ## ### # ######### ####   #### #  #
# #          # # #  ## ### ## ## #    ## ### ### ###### # #######  ## ######### ##     #    #  ###  ##  ## ##  # #   # ###  ##  ### #  ##  ## #
# ###### ### # # ## ## # # #   # #### ## #   ##    ## ### ###  #  ### # # ## ## ##### ## #### ##   #### #  ###   # # # # ## ## ## ### #### #  #
# # # ####   # # ## #  # # ## ## # #  ## ## ##### ##   #### ## ##  #  # # ## #  # #   ##  # #  ## ## #  ## # ### # ### #  # #   # ##  # ##   ##
# #        #     #  ##   # ##  # # ## ## #   # #  ## ### #        ## ## #    ## # ### ## ## # ##  #  ## ##    ##    #  # ## # ###  # ## #  ####
# ######## ## ##   ##  #    ## # #       ## ##   ##  ##  ######## ## #  # ##### # ##  ##  # #  ## ## #   ### ##  #### ## ##     ## #      ##  #
# ### #  #########  ####### ## # ### ### ##  ### ###  ## #   #    ## # ## ###     ## ##  ## # ### ## ### ##     ###    # ## #####  ## #####  ##
# # # ##  ## #   # ##  ## # ##     ##### ###  ## # ## ## ###   ##  # # ##   ##### ##  ## ##   ##      ## #### ### ## # # #   ## ## #   # ## ###
# # # ## ##  ### #  # ##     # #####   #   ##  # #  # #  ##  #####     #  ### ##   ##     # # ### ## ##   ###      ### # # ####      ### ##   #
#   # #  ### # # ## # ###### #   # ### ###  ## # ##   ## ###### ##### ## ## # ### ###### ## ### ####  ## ## # #######       # ###### ##  ## ###
### # # ##          #    # # # #    #  #   ##    #### #   ###    ###   # ##   #     ###   #  ##  ##  ##  ##    #  ##  ####### # ##    # ##    #
#   # # ##### # ### # ##     ###### ## ###  ### ## ## ### # #### #   ###  ### #### ## # #   ####  ##  # ##### ## #### # # # #    #### #  ## ###
###   #  ## #####   ###### #  ## ## #      ###  ## #  # # # # ## ### ##  ##     #   # ##### # ## #### # ## ## ##  ##          ####      ##    #
# ### ## #  ## ####  # ##### ##  #  # ####   # ### ## # # # # #  #   ## #######   # # ## ## # #  ###    ##    ###  ## #### # ##  ######  ## ###
# ##     ##      ### # #  #   ## ## #### ###   # #          # ## ## ##    # # ### ### ## #    ##  #  ########  #  ##     ###  # ##  #   ##    #
#  #### #### ## ## #   ## ###  # ##  ##    ### # # ## # ### # #     #  # ## # #   ##  ## ## ##### ## # ####### # ##  ########    ## ###  # ## #
# ##      ##### ## ## ##  #### # ### #### ##     #########  #   ###   ####  # ### ## ##     # ##  #     ##     # ## ## # # #### ##  # # ## ####
#  #### ### #    # ## ## ## #  # # # #  #  #####  ## # # ## # ####### # ###    #      ## ## # ###   ## ####### #  # #    # # ######      # # ##
##       ## #### # #  ## #  ##   # #   ## ## ####  #     #  ####      # # #### # #### ## #  #  ## ###### ## #    ## # ## #     ## ######      #
######## ## # ##   ##    ## ## #   ###    ## #  ## ##### ##  # ## ### #   ##     ## #######   ##   #  ## ## ####       ### #####    ###  # ####
#### #   ## #  ###  #### ## ######   #### ##   ##  # #    ##   ####     # ##### ###  ## # ## ##### # ###  #  ##  # # # ##    # ## ###   ## ####
## # ### #    ## ## ###       ## ### #     ###  ## # ####  # ###    # #####     ##  ##     # # ###   # ## ## #  ########### ## #  # ### ####  #
#     ## #### ## ## # ### ## ##  ##  ##### #   ###      # ## ##  #### ## ######  ##  ##### # # # # # # #  ## # ##   # ## ##  # ## # # #   ## ##
##### #                ####     #### ##    ### # ### ## # #  ##### #  ##  ## ###  # ##           # ### ## #     # ### ## ## ##  # # # # ###   #
#       # # # ########  #### # ## #  #####  #  #  ####    # ## ##    ##  ##  # ## #  #### #### ### ##  ## ## ####  ## ## ##  ## # # # #   ## ##
##### # ##### #        ## #### ## ## # # ## ##   ## #  ##   #  #####  ##    ##  #   ##  #####   #  ## ###      ## ###  #  ## ##   # #   ###   #
## #  #### ########### ## # #      # # #  #  # #### ####### # ## ##  #### #  ## ###    #### ###   ##    #### ####   ##   ##   ## ##   ### # # #
#    ##     ##          # # ###### # # ## ##    ##  ###  #     #  ## # ## ####  ### ##### # # # #### #### #   # ## #####  ## ##   ### ##    # #
## #  ### #    # # # ##         #    # #     # ####   ## ### # # ##    ##  ##  ## # ##  # # #    # #  ### # # # ##  ## # ##     ### #    # ####
############ # # # #### # # ###   ##   ####### ## ## ##      #    ### ##  ##  ###    ##   # #### # # ## #   # #  # ###    ## ##  ##   ## ### ##
# ##    ##   # ###### ### ############   ## ## ## #     # ## # ##   #  ## ### # # ####  #     ## #   #  ### ####     # # ##   # ##### ## ###  #
#    # ##### # ##   # ### #      # ### ###  #  ## ################# # ##  #         #########  # ## ## ## #  # ## #### ##### #####  # ## # # ##
# ## #   ##########     ###### #       # ## ## ## # # ##    # #        ## ### #### ##   ####  ## ## ## ## # ## ##  # #  ##    ## ## #  #      #
###### ### ###      # # ## ### #######   #  #     # #  #### # ###### ####  ## ######## ##  ##  #  # ## ##   ##    ## # ##### ##   # # ####### #
#   #   ## # #### ##### ## # # ######### ## #####   # ###   # ## ##  ## ## #      # #  ### ### ## # ## ####  #### ## # # ##   # #   #  ## #####
### ## ##    # #####    ## # ###               #  #   ##  #       ##  # #    ###### ##   # #      #  #   ###  ##          ## ######   ##      #
#       #### #  ## #### ## # ##  ############# ## ###  ####### ##  ##   ####   ## # #  ### ###### # ## ### # ##  ##########   ## #  #    # # ##
#### ## ##     ##   #    # #  ## ## # ### #    #######  ########## ## # #  ###    # # ## # # # #  # ##  #  #  ## #     # ####  # # ## # #### ##
# ####   #### ##### ## #   # ##  #      # #### #       ## #  ##  #    #### # # #### # ##     # ## #  ## ## # ###   ##### # ### # # ## #    #  #
#    ###      # # #  #####    ######### # # ## ####### #    ####   ##  ##    #    # #  #####        ##  ##   # ###   # # #          ### ##### #
## ########## # # ##  ##   ##  #####      # ## ##      ####  #   ###  ######   #### ## ##  ######## ### #  ### ##  ###   # ###### #  ## ### ###
## # # ###        ###  ###  #### # ######       ######    ## ######## #   ## #  ##  ##    ## # #     ## # ## # #  ## # ### ##   # # ##    # ###
#  # # # #### ### # # ## ##  ##        #  #### ## # ##### #   # ##  #   #  #### #  #### ###  # ##### ## #  # #   ##    # # ## ############# # #
## # # #  ### #          ###  ### ####   ##     # #   ##    #    ##   ####### #   ##     ###     ##     ##     ##### ### # ## # ## ##  ###    #
#  # # ## # ############ # ##  #### ###########   ### ######### ##  # ###  #  # ######## # ## ## ##### ### ####### # # # #          # ## #### #
##           ##   #  # #   ### # #      # ##    # ##  #  ###### ##### # ## ##    ## ##   #  #### #  ## ##     ## # #       ## ## # ##     # # #
#  ### ##### #### ## # # #     # ###### #  ######  ## # ##  # # # ##    ## ### #### ## # # ##  # ## #  ### #####     # ###  ########### ### # #
##  #####              #### ##   # ## #   ## # ###    #  ## # #   ## ## #  # #  # #  ### #  ##    # ##  ##  # #  ####### ##  ##   # # #   #   #
##### #   ############  ######## #    ### ## # # # ##   ##    ### ##### ##   ##   ##  #  ## ##### # #  ##  ## # ## ## ##  ##    ### # ## ## ###
# ### # ##### #      ##  # # #   #### ##       # ######  #### # # # # # #### ####  ##   ###  # #    ## ### ## # ##     # #########  # #       #
# #   ###   # ###### ###   # ### ####    # # #    ## ### ## # #            # # ### ## ### ##   #### ##  ##    #  # #####     ###   ## #### ####
# # ###   #          # ###            ## ####### ##           ## # ## ####      #  ## ##  #### ## # ###    #### ##  ## # ##### ## ###   ## ## #
#     ### ###### ###       ## # # ######### # ## ###### # # #    ###### ##### # ## ## ## ## ## #      ####   ## #  ##          ## ##  ####    #
##### # ######   #   # ###############                  # # ## # ### #  #  ####     # #  ##  # ## ######   ###    #### #########   ## # #  ####
##### # ##     # # # # #       # #     ## ##### # ##### ###### ### # ## # ##    ### # # ##  ## #     # ###     # ##           ### ##    ##    #
#        #####################   ### #########  ### ##  ## #   #     #  #  #######      ## ### ## # ##  #  ######## ####### ###   #  ####  ####
# # # ## # # ## # # # ##       #     ##        ##      ### ######### ## ## ##    # #### ##   # #  ##### # ####  # #       ### ### ## ## ## # ##
# # # #                  ## ## ### #  #### ###### # ## #    # ##           ##### ###     # ### ##  ##   # ## # ## # ##### ###  ##    #  ## #  #
# ### # ## ####### ##### #  #  #############    ###########   ######## # #  ## #  ######   # #  ##  ### #             ##### ## ##### # ### # ##
# ##########  # #    ########### ## # #    #### ##    #  ####   ###  # # ##    ##   # ### ## # ####  ##   #############  ## #   ##            #
### #########     # ##  ##### #  #  # ### ####   ####   ## #### # ## ### #  ##    #     # ## # #  # ### ####          ## #    ########### #####
### # # ## ## ## ######  #    ## ## # #    # ### ## ## ##          #   ### #### # ### #        ##   ##   # # ##########  # # ## ##   ## # # # #
#     # #      ### ## ## ## #       # ####   ##      #    ###### #   ######## #####   # ## ## ##### ## #       #### # ## # ###   ## ##        #
##### # ### ####   #   # ## ####### # #    ###  #### ######## #  ### ##  ## # ## ############ # # # ## #########      ##    ### ##  #### ######
# ##        ## ### ###   ######## # # ####   # ###      ##    #####   # ##  # #  # ### # ###        ##  #        # ####  ####   ## ##      ## #
#    ### ## #  #     ### # ##     #    ##### ####  #### #####  ##   #      ## ##       #     # #### ## ## ##########  ## # #### ##  ###### #  #
#######   #### #####          ### #### #  ##  # ## ###   ##### #### ##### ##  ######## #### ## ##   #  #  #  ## #  ## ##    ##  ## ##   ##   ##
# # # # ###     # ############# #  #   # ##  ## #### ## ##      #   #      ##  # #     ## ###  #### ## # ## ##    ### ## ######  # ## # #  ####
# # # ### #####     ####     #  ## ###    ## ## # #  #  ####### ### ###### ## ## ##### #   ##### ##  # #     # ## ##  #    #  ##   #### # ### #
#      #   #  ##### #  # # #   ##    ## # ##      ## ## # # #       #       #  # ### # # ###  ##  ##     # ###  ##### # #### ##  #  ##  # ##  #
# #### # #   ##   # ## ####### ### ###### ###### ##  ## # # ##### ### ## ## # ## #     # # ##  ## ### ## ###   ### #  #    # ### ##    ##  # ##
#### # ##### ####    # ## # ##      ## #   ## #   ##  # # # ## ## ########    ## #####      ##    # #  #     ####  ##   #### # # #####  # ## ##
##     ##         ## # #       ####    ## ### ## #### # # # ##  ### ## #   ## #  ######### #### #     ##### ### ##    #####  # ### #   ## ##  #
#  ###  ### ########   ### # # #    ##  # ##      ##        ## ##    # ######   ##     ##   ####### #    #### # ## #####  ##    ## ### ##  ## #
#######     #  # #   ######### ### #### #    # ## #########  #  #### # # ## ###  #####  ###  #  ##### ## # #       #   ## ## ##### ###  # ##  #
###   ## ## ##     #  ## ###   #   #      ######    ### # ## # ###          # ##  # ## ##   ## ## ### #### # ####### ###   #   # # #   ##  # ##
#   #    ## ### # ###      ############# ## # #  ##        # # # # # # ####   ### # ##  ### ## ## #     #  #   ###   # # #   ###     #### ##  #
## ### #  ###   # # # # ##   ## #        #  #   ##### #### # #   #######    #       ## ##   #  ## ### ### ## ### # ### ##### # ## ## # #     ##
#  #   #####  #####   # #  # ## ### # #####   ###      ##      #  # # ############# #  #### ## ## # # # # ##  ## # ##   ## #    ###      ## ###
#### # ###   ### ########### ##  #######    #   #### # ### # ####       # ### ##      ##     # #          #  ### #  ## ##  # ##  #  ######### #
#    ### ### #                ## # # #   # ## ###    ###   #### ### ###   #   #######  ##### # ######## ### ###    ###  ## # ## ## ##      ## #
## # #   # #### # ## ########    # # ### ###  ##  ## ##  # #     ## ##### ### # ###   ## #   # ##    ##  ##   ## ###   ##     ####    # ##  # #
#### ### # ## ########     ## ##         ####  ## ## ## ######## ####     #   # # ### ## ### #  #### ## ### ####  ####  #####  # # ####  # ## #
# #### # # ##  # #  ###### ########## # ## ###############        ####### ### #          # #   ####     #    ##  ## #  ## # # ## # #########  #
# # ##      ## # ## # #     ## # ######### # #  ### # ## ######## # ### #       ### ## #     #  # #### ## ####  ##    ### #               ## ##
# # ####### ##        #####         ## #       ## # #     ###             ## # ############# ##    ##   #  #### ### ### #   ## ############   #
#   # #      ###### #    #### # # #      #####        ### # ### # #### # ######## ##   ##    ### ##### ## ## #   #   #  ###  ###      # # ## ##
### # ### ##  ## #######      # ### # # ##     # # #####        ###### # # #  #    # ##### ###   # ##   #  # # #   #   ## ## ### ## ###   ## ##
#         ###      ##    ## # ###   #####  ### ##### #   ## ### #      ### ## # ##   ## ## #####    ### # ## # ########## ##      #  ## ###   #
### ####### # ## #    # ##  # ##### ## #  ##   ##      ######   ## # ####       ### ###  ### # #### #   # #      #####    ## ###### ##  # ## ##
##  #   #      # # ## # ## ####     #    ##  #  ## ## ##      ###  # #    ### # #   # ## ##         ### # ## ##### # #### #   ### #####       #
#  ####   # # ####### ###  # #  # # ## ###  ### ########## # ##   ############### #       ######### # # # #   # ##   ##     #      ## # ### # #
#### ## ### # ##       ## ##   ## ######   ###### #        ######## ###      # ##### ####  ## ##### # # #   #    # ##### # ##### #        # # #
#        ## # ####### #####  # #  ##     # # # #    # # ## ## ####   #  ## #    ## ####### #      # #     ########  # #### # ##### #### #######
## #### ##  ### ###     #### ######## # #### # #### #####   # #    #   ##  ## #              ## # # #### ######    ## # #        #   ##      ##
#  ##    ## #     ####### ##### #   ##### #         #     ### ################## ####### # ###  #           # # ####  #   # ####### ### ####  #
####### ######### # ## #    #   ### ## #    # ### # # # ### # # #### ### ## ##   #       # #   ### ##### # ## # ## ## # #####     # # #    ## #
#       ##  ### #        ## ###        ##################                      ### # ## #############    ###        #         #####   # #######
##### # #  ##     # ## # ##  ## #### #       #   # #      ### # # ########## # #######     ##   # #   ##  ## #### #   ### # ###   # # #       #
#     #### #  ## ####  #####  #### #########   #     ## # ##  # #### ###     ###       ########     #####     #######   ###     # # ### # # ###
#### ####    ##   ##  ###  ##      ## ##     ###### ##  #  #### #    #   ###   ## ######## # #  # # #     # #       # # #### #### ###   # # # #
#  ####   # #### ####   ##  ## ###       ## ### ##  ## ## ##    ## #   #   ########   #    # ###### ## # ## #### # ## ### ############# ###   #
##  # ########     ## #####    ##### # #  ####     ##  #  ## ######## ### ##  ##    #   ##          ## # ##    #####        #   ### ###  ## ###
###      # #   # ###### # ## # #     # # ##    # #  # ########## ## # #   ###  ### ### ##### # ### ##  # #  ##   #### ## # ## ### # # #####   #
#### # #     # # #           # # # # # # #  # ## # ## #               # #   ##     #   #     # #    ## # ## ## #    #  # #                ## ##
############################################################################################################################################ ##
