# #############################################################################################################################################
#            ##   ##          ##  ##  ##     # #  # ##   ## # # #  ## ## ## ## ##  # #    ##     # # ##  ## # # #  ##  # # #     # ##    # #  #
######### ## ### ########### ### ##  #### ## # ##    # ###    # ## ##  # ## #   ## #   ######## ## #  # ##  # # ## ### # #   #####  ## ### # ##
## #### ###    #  ## # #     ##  ### # ####     ## ###   #### # ##  # ## #  ###  # # #  ## # #  ## # ##  ##   #  # # # #   ##### # ##   #  #  #
#        ##### # ###     # #  ##  ## #   ######     ## ### #    ### # #  ## # ##     # ##    ##  #   ## #####   ## # #   #   # # # #  ### ## ##
#### # #       # # ## ###### ##  ##  ## ##  ####### ##  ## ####  #  # # ##    ## # ###  ## ##### # ####   # # # #  # # ### ### # #   ## # #   #
## ######## ##      # ### #     ##  ##   ## #   #   ## ##    ### # ## # ##### ####  #####  ##       ##  ### # #### # # # ####    # ###      ###
#   # # #   #  # ###### # #####  ## ## ###  ### ### ## ### # #   #  # #  ## # #    ## # ## #### #####  #### # ## # # # # ## # # ## # # ###### #
# ### # # ###### # # #    # # # ##   #  ## ###      ##  #### ###   ## # ###   ####      ## # #  # #   ##       # # # # # ## # #### #   # ## # #
#  #    #### ###     ####   #   ## ### ###   ## ### ## ## #  ##  #  # # # # #### ## ######   ## #   #  ##### ### #   #    # # ## #   ### ##   #
## ####  ##      #####  ### ### ## ##  # ###  ###   #  ## # #### ## # # # #  ##      ##  ## ##    ###### ##    # ###   ## #        ###   ## ###
#  ## # #### ### ## ## ## # # #    ###   # ## ### #   ##  # ####### #     # ###### ###  ##  ### #####     ## ### ##  #  ### ########## ####   #
## ## #  # # #    # #           #### ### # ##   #### #### #  ## ##  ### ### ## ##  #   #### #   ### #####  # # # #  ## ####  # ##  #      ## ##
#   # # ## ##### ## ## # ######    #  ## # ## ####      # # ##   ##  ## # # #   ## # ### #    #   # ## #  ## #   ##  #  # ##      ## #######  #
# #      # ##     # ######    # #### ##    ##  ##  # ##     ## ##### #    # # #### # # # ## #######  # ## ## ### ## ##### ## ######   # # #  ##
##### ## # ##### ##  ##  ####     ## ##### ###  # ##  ##### ##  ## # ####   #  # #     # #     # ### #    #  ##      ###  ##      ## ## # ##  #
## ##### #   ##   ## #  ## #### #### # ###  ### # #  ## # #  # ##  # # #  ### ## ##### #   #####  ## ## ### ### ####   ##  # ######   #   ### #
#    #     ##### ### ## #   # # ###  # # # ##   ######    ## #  ## # # ## #    # ####  # #### ## ###    ##   #   ### #####        ## ## ### # #
#### #####  ## #  #   # ###     # ## # # #  ###  ## #### ### ## ## # #      #### #  ##             ## ###### # ### ### #### #######  ## # # # #
#          ##  ## # #    ##### ## ##     ##  #  ##   ##  ##   # ##     # ##### #   ### ####### #####   # # #       ##   ##  #   # ## #      # #
########## ### ## ##### ## #   ## ######  ## ## #### ###  ### # ###### # ### # # ####   ## ######  ### #     ######## ###  ## ### #  # ###### #
### ##     #      ## ## #  ## ### # ## # ##       #    # ###    # ##   ### # # #  ##  # ##    # # ## # ## ###### # #  ##  ##   ## ## #  #     #
#   #  # #   # ## #   # ##      #   ## #  ## # ## #### # # #### #  ###  ## # #   ###### ## ####   ## #     ##  # #   ### ### ###  ##   ## #####
### ####### ##### ## ## #######   #### ##  #####         #   ## # ##   ##  # # #######      # ## ### # ### ### # # ### #         #####  # # # #
#    ## # ####        # # # ### # ###   # ### ####### ##   ###     ### ### #    # ##   # # ## ## ##    #####     # # # # ##### ###   ## #     #
### ##     # ######## # # # # ###   ###   # # # #  ####### # #### ##     #   ####  ##### #### ##  #### #  ######     # #    #### ### #    #####
# # ###### # # # ## #   # # # ##  ### ## ##   # # ## # #     # #   #####   # #### ##  #   ##  ###  ### # ## # #  #####   #### ## ##  ## #  ## #
# #   # ## # #        #   # # #  ##   ## #### #   ##     ###   ###  ##   ### #  #  ## ###  # ## # ##   #  #   ##   # # #    #     ## #####  # #
# ### # #    ##### ## ### # # # ### ####  ##  # ####### ###### ##  ##### ######   ##   ## ##  # #  ###   ## ###  ### # ###### #####  # ##  ## #
#     # ## ### #########      # # #  ##  #### # ##  ###### # #  ##  ## #   ## # ###  #### #  ## ## ##  ###  # ##     #  # ##  # # ## # #  ##  #
#####   ## ##  #  # #    ### ##     ####  # # #  ##   ##   # ## ### ## # #  # #   ##  # # # ##  ## ## ## ## # #  ##### ##  ## #   ## # ## ### #
# # ### ##  ## ## # # # ##    ## #### #  ## #   #####  ### # ##  ## #  # ## # # ###  ## # # ## ##   # #     # ##  # ## ## ##    ###  # #   ## #
#   ##  ###  # ## # ######## ##  ## # # ##  ## ## ##  ##     ## ### # ####  # #   ## #      ##  ## ## # ##### ###         ## # ## ##   ###  # #
# #  ## # # ## #     # # #      ### #   ### #   #  ## ######  # # #   #  ##   # ###  ## ### ## ##     #    ##  ## ### ## ##  ####  ## ## # ## #
####  # #      #### ##   ######  #  # #  ## ###   ##    #### ##   ## ## ##  # # # ##  # #    #  ## #### ##### ##    ########  # # ##  ##   ## #
##### # ##### ##     ### ## #   ## ##### ##  ## ###### ##       ###  ## #  ####    ## ##### ## ##   #     # # ## ## ### # #  ## #  ##  ###    #
# ###   ## ##  ## # ## # ## ## ###  ## # ###     # # # ########   ## #  ## # ### ####  ##      ## ### ##### # #  #### # # ## ## # ##  ##   ####
#  #  #       ##### ##       #   ##  # #  #### #   # # # #    ## ##    ##     ##  # ##  ## # # #  #   ####  # ##  ##  # # #   # # ## #### #####
## ## # # ###  # #   ### ###   # ### # # ## #### ### #   # ##     ## # ## #####  ## ### #  ###### # # #  ## #    #### # # ## ## # ## ####  #  #
## ######## # ## ## ## # #   ##### #      # # #      ###    #####  ### ## ## ###    # # ##  # ##    ### ##  # #### ## # #  # #        ##  ## ##
#  # # #### # ## ## ## #####  # #  #### ### #   ## # # ## #### ###  #   # ##  ### #   # #  ## #  ##  #  ###    ### #    # ## ### ########  #  #
##   #  #               #  ## # ## ###  #   # ######## #####    ### ## ## #  ## # ##### # ###   ###### ## ## ### # # #### ## ##     ## ### # ##
#### ## ## ## ## # ####   ##    #  # ## ### #     # #   ## ## #     #   # ##  #    # ## #     ###  ###  # #  #        #   ##  ## ####  #   #  #
#    #  #######  ###    # ## ## ## #  # ##    ##### ### #   ####### ### #    ## #### #  # # # ### ## ## #   ## ### # ## #####     # ## ### # ##
#### ## # # ##  #########  ###   # # ##  ## ### ##  # # # ###        ##   # ##  ###  ## # ##### # ## ## ### #   ####### # # ## ## # #  # # #  #
## #    #   #  ### ## #   ###  #     ## ### ##  ###         ########    ###  ## # ## ##    # ##   ##  # #   # #   # # #     ##  # # ## #     ##
#    ## ### ## # # #  ### # ## ## ##    ##   # ## ##### ###  # #  ## ## ######  # #  #### ##  ## ##  ## ### # #####   ## ####  #### #    ###  #
#### #  # # #### # ## # # #  ########## ####       #########   ##  ####     ###   ##  ##  ## ##   ##  # ##  #  ## # ###     ## # ## ### ## ####
###  ##   # # #     #     # ####    ##   # # #######  #    ###  # ##    ##### ### #  ### ##   # #    ##  ##   ##  # # ## ####    ## # #       #
#   ##### # # ##### ##### #  # ### ### #        ## ## ## ### ##   ##### # # # #     ##      ######## ## ### #####           ### ##  # # #######
## ###    #                 ## # # # ##### # # ### ## ## ##     #  # ## #   # ##### ## ###### ## ##   # ##    # # ###########   ## ##      # ##
#  # ####   ############## ### # #   ## #### ### # #  #   ####### ## #    ###  ## # #  ###  # ## #  ###  # ####    #  # # # ### #     ## #    #
## #      # #                  # # ###    #   #    ## ## ##    #  #    #### # ##  #   ## ## # #  # ## ##      ### ## ## # # ##  #### ##########
#### # # #### # # ###### ## ##      ##### ### # #####  # ##### ## ####   ##   ### # ####  #   # ## ## ## ## ### # ##  #   # ## ### #  # #     #
# ###### # ######### ##   #########  # #  ##      # ## #  ## # ## ## # #### #  ## #    ##   #   #  ## #   ####     # ## ### ## # # # ## # #####
# # # #  # #  ## #    ####### #  ### # ##  ### #### #    ##  #  #       # ####  # # ##### #####   ##    #### #### ##     #  ##   #   #      # #
#     # ## # ##  #### ### #     ##   # #  ##    # # #### ### ## ###### ##  # ## # # ###    ########  # ####  #  #    # # # ##### # ### ###### #
##### ###     ## ##   # # ##### ####   ##  ## ### # #     ##  # # #    #  ##    #   # # ##  # ## ### #### ## ## # ######## # # # #  #    ## # #
### # ##  ### ## #  #         # #  ###    ##  ##    ##### ### # # ####   ###### # ### #  ## #  #  ##  ##  #  ##   ### # #  # # # # ## ####  # #
#   #  ## #      ###### ### #     ##   ##  ##  ## # # #    #  # # ## # ######      ## # ###### # ####  ## ## ## #         ## #           ## # #
### ## ##### # #  ## #### #######  ###### ####  ###   ####   ## #       # ##  # #####    # ##  #   ## ##  #     # #########  ## ## # ######   #
#      # # # #### #   ### ##   ### # #  # # ### ##  ###  ###  # # # # #    ####   # ## ###  ## # ###  ### # ###########  ## ##   ###### # # ###
# # ##   # ####   # #   #    #  ## # ##   # # # ### # ##   ##   ##########  ##  ### ## # ## ##   #   ## #       ##    ## ## ## #### ##  # #   #
########    # ### ##### #######       ### # #    ##    ###  ###  # # #     ##  ##   ##   ##    ### #### ## ####### ####   # ## ## #  ## # # ###
## #  ##### #      ##       # # # ###   # # ### #### ####  ##   ##   #####  ##  # ##### ##  ##  ## # #        ##      ###   ## ##   ### # # # #
#  ## # # # ###### ########     # #   #     # # # #   # ## ## #  ### #  #  ####    # ##  ## ######     # ## ##### #####   ####  # ### # # # # #
## #         # ##  #     ###### ### # #####   # # # ### #   # ## ##  ## # ##  ### ##  ## ##   ## # ### ###### ##  ### ### ## # ##  ## # #   # #
#    ####### # ### ##### # ## ##########    #        #  ## ##### #  ##    ### ##   ##    ## ###  # ####### ##  ## # # ##  #       ###   ## ## #
#### #         # # # #         ## ## # ###### # ## #   ##  # ##  ##  ####     #  #### ####  #   ##    ##   ## ###     ###   # # ####  ###  #  #
#    # #### ##       ###### ## ##    # ########  #####  ##    ## ## ##  # # #   ## #     ## # #### ##### ####     ##### ## ########  ##### # ##
## # ####   #### # #   ###  #     ##   #    ######  #  ##### ##  #  ## ####### ### # ######    # # # ##  ## # ###### #  ## # # #  # ##  #     #
####### ## ##    #####   # #### ###### ### ## ## ## ## ## #  ### # ### # # # # ##    ## ##  ####      ## ##    ### # # ##    #   ##  ## ## ####
# # # # ####  ## ##    # ### ## #              #        # # ##     # # # #   # ##### #   ##  # # ######     # ##   # #  ## ### #####          #
# #          ##   ## # #  #   #### ### # ### #   ## # #      ## # ## # # ### #  ## # # ##### # #  ##  ## ######### # # ##        # ## #### # ##
# ### # #########  ###### ## ### ###   ###   # #  # # ## ###  # #  # #    ## # ##    # # # #   # ### ##      # # #   # ## ########    #  ###  #
# # ######### # ##### # # ## ##   ############ ## # ######## #### ## ### ### #  # # ## # #   ###  #   # ######   ### #           #### # #######
# #  # #         ##           ### #  ##   #     ### ##        ##   # # # # #   #### ##     ### # ## ###  ###   ####    ## # # #### ##       ###
#   ##   # #### ######### # #  #  ## #### ################# #  ## ##         ### #  #  #######       ## ## # ### #  #########         # ##### #
###  ## ####     ##     ### ## ## #          ###   ## ####### ##  ######### #### ## ## #   # ## #######  # # #   ##    #    # # # ## ##       #
#   ##   ##### # ######     #  #    ### ### ## ###  # #   #      ## ##  #   #  # #  ## # ### #   # ## # ##   # ###  #### #### # # #   # ## ## #
###  #####     #  ### ########   ## ##  #      ##  ## ### ##### ##   ## ###   ## ## ## # ##    #         # ### # ##   #   ####### ### #  #  ###
#### ### ####### ##    ##### ### #  ###### # #  ## ## ##   ##      ###  # # ###  #   #      ##### # # #### ###      # # ### #######   # #######
# #  #      # #   ####       #   ##   ######### ## ##    #  ##### ## ## # # # ## # ### ### ###  #######      ## # ### # # # # # #### ##  ###  #
# ## ######   ###  ######### ## ####### # # #       ## ####  ##   ## ## # # # #    # # # ### ##  #   ## #### ## ### ### # #       ##  ##     ##
# ## # ## ### # ## #  ##         ##       # ### # ####### ##    #             ### ##         ###   #### ## # #   ##  #  # # ###########  # #  #
#    # ## #      # ## ######## ##### ## #     ###  ## #   ## ##### # ####### ####  # #########   #####   # #### ##  ## ##         ###### # # ##
# ##   #  #### # # ##  ####     # ###########     ### ###     ##   ##### #   ## # ## # # ## ####     ## ##  # #  # ##     ## ####  #  ######  #
# #### ## ###### # ### #  ####### # #  # #  ##### ##  # #### #### ###    ### ##   ## # #  # # ## #####     ## # ##    # ####  ####   ## # #####
### ## ## #   #    # # # ## # # # # ## #   ## #    ##   ##   # #####  ## #   #### #      ##    #  # ### #####      ####### ##   ######        #
#       # ### #### # #              #    # ## ####    #    # #  ## ## #  ###  ##    # ## ## #### ## #     # ## ###     #   ###### #### ########
##### #              #### # ## # ##   # ##  # #### ## # # ##### ## ##### ### ##  # ## #      ###    # ##### ## ### # #   ### ## # #  #  # # # #
### #### ## #### ###      # ###############         ### #  ## #    # #          ####  ### ##   ## ###   # # #    # #####        #   ## ##   # #
#      ######    ##  # ###### #  # #  ### ### # # # ##  ##### #### # # # ###### # ###   # ## ####     #       # ##  # ### # ##### ###     #   #
### ####      ## ## ## #        ##   ## # #   # ### ## ####          ####### ##     ## ## ##      # # # # ## ######     ######     ## ##### # #
#    ##  # # ######  ### # # ## ####    # ### #  ##  #### ### #### #  # #       ## #####   ## ## ## # # # ##   # #  # #   ##   # #      #######
## #    #### #      ###########  #### #    #### ########      ####### #   ## # ##     ####### ## ## # # #  ## ## ##########  ### ## ### # ## ##
#  ### ##### ## # # #  ## # # ##   ##### #         ##    #### #   # # ###### #  #####  #    ####  ### # # ##      ## # ## ##   ####  ##       #
## #    ##   ###### ## #       ### # #   ## ### # ##  #####   ###     ####   ##     ##   ##### ##   #####  ### ##            #    ##  # ## ####
## ## # ####  ###   ## ####### # # # ### ## ##  #########   ##### ###      #  ## # ##  #        # #####   ######  # ##### # ## ################
#  ## ### ## ## ### #   #             ## ## #  ##   ###   ###   ####  # ## ##  # ##### ##########     ###      ## #   ##  # ######  ##        #
## #  ##     #  #######   #### #### #    ## #######     # ##### ## ########### #### ##   # ##   ### #  ## # ##  # # #  # ##  ##    ##  # ######
#####  ### #### #   #### ############# # ##  ## # ## ######   # ## # # # ## #        # #    # #############  # ####### #  ##    ##    #### ## #
# # ##########  # ### ####             # ## ##    #### # ####                 ## ## ## # ##       ##      ## #       ######## ###  # ## #     #
#            ##            ### # # # ### ########  ##         # ### # #### ##  # ## ## # ## # ###### ####### # ## ##### ## #  #### ###    ## ##
## # # # # #  ##### ## ### ### # # ###   # # ## # ##  ###########   # ##   #  ##  #  # #  ###   #        ##  # ##          ##   ##  ### #######
#  ########## ##     ###   #   ### #   ###           ##    ### #  # #  ## ###  #### ##### ##  #   ## ####### # ## #### # ##### ####        ####
##### # # #      ######### ### ##  ######  ### # # #  ####       ## #####  ## ####### ##  ## ## ###  #### ## ###     ###  ## # # #### ####   ##
# # #   #   ## # ##     ###### ### #### ########## ##### ## # # ###### #  ##           ##  # ##   ##      ####   # #   # ##        ##    # #  #
#     #   ###  #  ### #  ###   #   #          # ####  #     # # # #      ##  # # ######### # ## #### # #### ### ## ## ####### # ## #  #### # ##
#### ## # ##  ### #   ##     # ###### # ## ## # # ###   # # # ### #### #  ## # #        #### #     # #    #  ##  ###       ####  # ##   ## #  #
###  #  #  ##  ## ## #### # ## #### # #  ####   # # ### # # # #        ## ## ### ### ## #    ## # ##### #   ####   ## # #### ######### ########
#   ### # ####  #### ##   #### #      #####   #     #   ############## #  #  ##    ###### # ##  #   # # ## ############    # #   ## ##        #
###  ## # ##   ##    #  # ##   # ## # #  #  # ### #   # #              # ### ### #     ## #  # ## # #    ### ## # # ### ##     #     # ###### #
######  # #  # ## # ######## ### #  # ##   ###### ## ####### ## # ## # # ##    # ## ##  ### ####  # ### ##    # #     ##### # ## ## ##     ## #
#      ## ############       ##  ## #  ## ## ##    ###       #  # #  # # #  # ## ## ######  ##   ## #    ## ###   # #    ## #  # ##  ## # ##  #
# # ## ## #            ## # #### ## # #####     # ##   ## ## #### # ## # ## #  #### # ## # #####  # # ##        ############# ## #  ##  # ### #
# # #   ### ## # # # #  ###  ##   ###  # ###### #  ### #  #  ###  ###  # #### ###        #  # #  ####  ## # ### ## # ## ## ########  ## #   ###
# # ## ##   #  # # # ## ##  #### ##   ##        ## #   ## # ##   ##   ## #    ##  # # # ### #   ##    ##  #   #                  ## ##  # #   #
############################################################################################################################################# #
