# ##############################################################################################################################
# ## # ##     ##   #    # ## ##  #  ## ##    ##  ## ##  #       ##         # # ##   # # # ###      ## ## ##        #  # # #  # #
# #     #####  ### # #### #  ###   ##   # ####  ###  ## ## ######  ### ### # # ### ## # #  #  ####### ## #  ######## ## # ## # #
# #####  ## # ## #    ##  ## # ###  ###    # ##     ##  #   # # ##   ####### #  ##    # ##   ### ###  ## ##    ##     # # ## # #
# #  ### ## # #  ## ###  ##  # ####     #### #### ##### # ### # #  #  ##  ## # #### ### #  ### # # ## #  ## ####### ### # #    #
# # ##          ##    ## ## ## # ###### ## #  ##  ## ##    ## # # ###### ##     # # # #   ##        # # ### ## ## #         ####
#      ######## ## ##### ## ## # # # ## ## # #### ## #### ###        # #  ### ###     ### #  ######## # # #     # # # ### #    #
######## # # ## #   ## #  # ##     #       # ##    # # #  ##  ## ### # # ##   #   ### #   # ##   ## # #   # # ### # ############
######## # # #  # ###  ## # ###### ##### #    ####       ####  #  #### # ## ### ### ##### #  # #### #   #   ####             ###
#      # # # ##     ##    #  ###      ##### ### #  #######  # ###   ## #      # ###  ##     ## ## #   ######## # ###### ###### #
######       ### ######## # ## ### ##   # #  ## ##  # ## ##    ####  # # ###### # ##  ### ###  ## # ### ###           ####     #
# # #  ## ##      ### #   # #   ####### # ##  # #  ##     ## ### #####     ###  # #  ##     ## ## #         ## # # ##  # # #####
#     ##  #  # # ## # ### # ## ## ## #     ##   # ### #####   ##  ## ## #### # ## ##  # #####       ##############  ##     # ###
# ### ######## #  # # # # #  # ##  # ##### #### #      ###  #### ### #   ##  #    ###   ###   # ###   ###       ## #######     #
# #     ## #   ##         ## #  ## #        ### # ###### ##  ##   #    #  ## ## ### # #     # #   # # # # ##########     ## ## #
#########    # ### ######    # ##  ####### ##   #   ##   #  #### ## ##### #  ## # # # ### ##### # # #                #####  ####
####### ######## ### # ##### # ###  ### ##  # #   ###  ### ####  ##  ## #### ##         #     # # # # # # ##### ###### # #### ##
# #   #  ## # #      #          ## ##   #  ###### # ##   #  ##  ##  ##   ##  ## ######### ############# ########## ###         #
# ## ## ##    #### #   ########  # #### ##  ##         ### ####  # #### ####            #          ##          # # # # ##### # #
#        # ##    ######## ####  ## #       ###### ######     ###    ##   # # # # # ### ## ############ ## ## #            ## ###
## # ##### ##### ##   #      ## ## ### # #  # ##   #   # ##### # ###### ##   #####   #########     ##   ###### # # ## # ########
#  #    ##  ## #  ### ## # #    #  # ##### ##  ## ## ### # ###       ## #  #    ####### ##   # ########### ##### #  # #        #
# #### ######  ## ##     ###### ## # ## #  ## ##     # # # # # #######    ##### #     #    #                 ### # ##### # ### #
####    # # # ##   ##### #####       ## ## ##  ## #### # #       ## ## #### ##### ##### #### ## ####### ### ## # # # #####   # #
## ### ## #    ## #### ### # #### ##       ## ##    ##     #######             ## ### #   #########   #   #    ###    # ### ## #
#  #    # ### ##  ##    #  #   ########### ##  ## ###  #####   ### #### ######### # #   ###   ### # ### ### ##  ## # ##   # ####
## ### ## # #  ##  #### ## ###   #         ## ### #### # ### ###     ###### ##        ### # ###       #####  ##  ###    ###   ##
#             ##  ## #   #  #### ######### ## #      #     # # ## #### ## #    ##### ##   #     ## # ###  # ####   ####   ###  #
### # # ### # ###    ### # ##      ### # # ## ### # ## ##### # ## #  # ##   ##     ###  #   ########## # ## ## # #   ### #######
#   ### #   #     ##        #### #            # # #### # # #    # # ## ## ###### ####  ## ###    #####    ###  ### #   #       #
# # #   ### ############# #      ############      # #     # #### #        ## #####   ####### #### # # ##   ##  ##### ##########
# # # ####  #  ### ###    # # ## ##   #####   # ##     # #   #### # #### #  #       #       # # ##      ## ####     ### ##     #
### ###    ###   # # # #### # ## #  #       # #  ## # ## # #           # ##   # ## ########      ## ######## #  ###        ## ##
######  # ##   #   # # ###  ############### # ##  # # ## ##### ## # # ##  ## ####### ###  ## #####    # # ## ##   ### # ####   #
#  # ######## ## #     #   ###  # ## #      # ## ## #  #     ###  #######  #             ######### ####    #  ## ######    ## ##
##   # # #    #  ## ## ## ## ## #      # ## # #   ###### ###   ##       # ## #### # # # ######          #### ##      ### # ##  #
#  #     #### ## ## ## #  #       ### ## #  # # #     ##   ## ##  #######  #   ########## ## # ###########      ### ## #########
## #####      ## #  ## # ##### ## ##   #### # # # ## ##  ###  ###       ## ###   # # # #   # #    ###      ## #  #####      ## #
#  #     ## #### # ##  ### #####  ## # #    ### # ######  ###   ## # ######### #         ###   ##     ########## # # # #### #  #
###### #######   #########       ######### #### #   ## ##   # # ## #       # # # ### # # # # #  # ## ###      ## #     # #### ##
#      ##      #### # ## ### ##### ## ##      # ## ##     ######## # #### ## ###   # # ###   ##########  ######### #####  ##   #
######  ### # ####           ##          # #### ####### #        # #   ##      ## ## #  ## #      # # ##    ## ##      # #### ##
# ##   ########  #### ## ## ######### # ##   ##      ## # ### ###### ###  ## ##########    ######## #    ####   # ###### #     #
#  ###### ## ### ## ####### #         # #  #  # # # ##  #   #    ##    ## ##          ## #    ## ##   #### ### ##   ###    # ###
##      # ##      # ### # # ####### # ### ##### # #  ## # # # # ### # ####### ## ## ###  # ## ##  # ### ##  ##  # ### # ###### #
### # #    ######           ##      # #   #   # # ####### # # #   # #      ##  ###    ## # ##    ## # # ## ##  ## # #    ## ## #
# ###### #  # #### # # # ##  ## # # # # #   ### # ####    # # ### # #### #####   ## # #  #  # ##              ### # # ####   # #
#  #     ##        # # #  ##  ### # # ### #   # #    #### ###   # #   ##    ## ###  # # ## ##  ## ## # # ## # # # #     ## ### #
## ##### ### # # # # # ## #  ##   # # #   # ##### # ##     ###### # ###  ############ #  #####  ######## #  #       #####  #   #
#   # ## # ##### # ###  # ##  ## ## ### # # ###   ###  # #      # #   ##            # ##    ###      ##### ### ####   # ##   # #
# #      #       # ##  ##### ##   ###   # #   # #   # ## ## ##### # # #  # ### # # ###### #   ## ###    ## # #    ###      #####
# # ### ### # ## ###  ##     ####  #### # ### ### ###### ##     # ### ## #  ######## # #  ## ###   #### #    ########## ##### ##
# # #    #### #  #   #### # ## ## ##    #######   ##     ## # # #   # #  # ##          ## ## ##  #    #### #     #    # ###    #
##### # ##    # ####  ##  # ##    #####       # # ### # ##  ###### #######    ## ## # ##   ###  ## ####    #####   ####     ## #
## ## #  ### ## #    #### #  ####   ##  ## ######  ## # ### ## # #   # #   # ###### # ### ##   ##     ####   ##  #    ## ## ####
#     # ##   ##### #  # # # ##    ###  ##      ### ## ### #      ###   ## ## #  ##  #  ## ### #### ##  ### # ## #####  # #    ##
## # ######### # ### ##   #  ### #####  ## # #  ## #  #     ############   #   ### ### #   ##  ##   ##   ### ##     ## # # ##  #
#######           ##  # # ####   #  #  ### # ##  #### ### #            ## ### ###    #### ##  #### ###########  ## ##### #### ##
# # # ##### # # #    ####  # ######   ## #######  ##  #   # ## # ## #####   # # ## ###  #  ##   ##    ##    ## ##      # ##    #
#     ##    ###### #  ##  ##    #   #  # ## ## # ####### ## #  # ##     ## ## #  #  ###   ##  #  # ##    ########### ####### # #
#####    ##### # # # ##  ######   # ##         #  ##      # # ##  ## #####  #   ###   ## ###### ##### #### ##  ## ####     ### #
###### # ##        #  ## ## #### ## ## # ## ## ####### # ####  # ##      ## # #  ### ##  ####     ##     # ## ##       #####   #
#      #  #### ## ## ##  #       #  ## #  #  # ##  # ###   ## ## #### ##########   #####  ##  # #  ####### #     ####### # #####
## ##### ##    ## #  ## #### ## ### ## ##### #  ##       # ## #   ###      # # ######  # ###### # ## #####   ########### # # ###
######    ### ##  ## ## #     ### # ##     # # #### ### ##### ## ## # ## #            ##### #   #          # ##                #
#      #### # ###  ####### # ##     ## ## ####### ###       # ##    #  # # # ## #####   # #   # ## ## # # ##    # # # # # # # ##
#### # #       ## #### # # ######## ####### # # # #### ### ##### # #########  #     # #   ## ##  ###  # # ## # ############ #  #
#    # ## ########## #     #           #  #     # #      ###   ###         #### ## ##### ##   ##   ## # # ## #  ## # #   ## # ##
# # ## #  #          # # # # ## ## # #   ## #####   ## #     ####  #######  ######  ## ##### #### ##  # #  ####        #### #  #
# #  # ## ## ## # ##   # # ###  #  ### #    ##  ## ### ## ####    #########      # ### ###    ##  #  ## ##   ## ## ###  # ### ##
# # ####  #   ###  ### ###   ## ##   # # ##    ##  ##  ##   ## ##         # ######   # # ####  ## ##  ##### ##   #  ###    ## ##
### # ###### ##   ##   #   ######  # # # ### #####  ## #  #  ###  # #######   # ####      # ##### ## ### #   ## ###   ####  #  #
### #   ## #### ######## #   ##   ## # ### # ###### #  ## # ##   ##       # #      # # # ## ##  # #      ## ##   ####    #######
#   # #         ##       # ###### ## #  ##     ##   ##  # #  #####  # # # # # ## ##### #       ##### # ####  ## ##  ## #     ###
# # # ## #### # ###### # #   ##   ## # #### # ### #  ## # ##     ## ### # # #  #   ##  # # # #    ## #    ####     ########### #
######## #    # # # ## # ### ## #  ###  ##  # #   # ##  #### # # ##  ## # ### ## ##### # ###### # ## # # ##    ## ### # ## ##  #
#        # # ## #      #  ## ## ## ### ##  ###### # ###  ##  # # ##########   ##    ## #      ### ## # #  ### ##    # # ## ## ##
####### #### ## ## ##### ##  #   # #   ## ## #  ###   ##  ## # #       # ####  # ######## #########  # # ##    # ##   #        #
#       #    #  #  #     ### ## ## # ####      ##   ###  ######## # ####  ##  ##  ###             ## # # ## ## ##### ## ### # ##
### # ###### # ### # ## ##   #  ## ####   # # #####  ### #     ####    # ####  ##   ### # #### ####  ###  # #   ##       ####  #
### #  ##    ###   # #   ## ###  # #    # # #   ##  ##     ##### #  ##    # ####  #  ## #    ####### ##  ## # # #  # # #   ## ##
#   # ### # ######## ## ######  ###### ## ### #  ##  ### ### ##    #### #    ####### ## # ##       # #  ### ### ## ### ###  #  #
# # ###   # #   #### #    ##   ## # ## #    ### #### ##      ## ##    # # ##       ######  ## ## # ### ## #   # #   ##  ## #####
#####   # ### #      ## # ## ####    # #######  # ##### # # ##  ## # ## #  ## # ##  ##  # ##   ######     # # # ## ####  # #   #
#     # # #   # # ## #  # #  ##   ##         ##   # #   ########## ###### #####  # ### #######    ##  ### # # #### # ## ##   ###
## # ## # ### # # ## #### ##  ## ##### # # # ## ###   #   ## # #      ##   # ## ##   # # # ##  # ####  ## ### ##   # ##  # #   #
#  # #  # #   ### ## #     # ##  ## ## ### # ## #   # # #      ## # #  # #    # ## #       ########   ###   # ## #   ## ## ### #
#### ## ##### #####  ## # ##### ##      ## #### ## ## # # # ##  # # # ## # # ## ###### # #    #   ### #   # ###  # # ##  #   ###
######  ##        ####### # ##  ### # #  #    ###  ## ### #  # ## # #  # # ###       # ### ##   #   # ## ####   ## # ## ## #####
#      #### # ### ### #      # ## ### ##### #   ##### #   ####  ### ######   ## # # ##  ## ############   ##  # #### #  ##     #
### #####   # ##  #     ## #####   ##  ##   ## #####  # #    ## #       ## #### ###  ##  #            ## #### #   ## ##  # ### #
##   ##   # # ## ### # ##   # #  #    ##  ######     ## # ##  #### # ########     ##  ## # # ###### ###  ##   # #### ## ##  ## #
#  # #  # # # ##  ####  ## ##   ### #  ##   # ### ## ## #  ##  ##  #      # #### #### #  ###    ####### ##  # #    ######  ##  #
# ##### ##### ##### ## ###  ### #   ##  # ###     ## #  # ##  #### # # ##     ##### ####  ## ##    ## # ####### ##     ## ### ##
### #    ##   #          # ##   ## ### ##   ### #  #### # ###  ##  # # ## ### # # #  ##  ##   ## #    #  ###    ## ######   #  #
#   ## #  ### ## # ## # ##  ## ##    ###  #  ## ##   ####   ## ### ### ##   #       ##  ##  #  ### #### ## ## # #  ###    ### ##
# #    ##   #  #####  ###  ##  ### #  ### ## ## #  ###    #### # #  ##  ## ### ## #####  # ## ##      #    ## ### ## ####  ##  #
### # ##  ####### #  #####  ## #   ##   # ## ## ## ##  ##    # #   ##  ##    # #    # #### ##  ## # ### # #######      #####  ##
#   # ###   ### #   ##     ##  ## #### ##### #  #  #  ##  #### ## ##  ### # ######### ##########  # #######     # ###### #### ##
#####  ## ###     #  ## # #### ##  # #  ## # ## ## ##  ##    # #   ##   # # # # ## #         ### ##       # # # #    # #    #  #
#     ##   ## # # ##  # # #     ##   ##    # ## #  #  #### ###### #### ####          #########    # ### #######   ##     # ## ##
##### ## #  ### # ### ### # ## ##  #  ## # # #  ## ##  # #     ## ##     ## # ### ##    ## # ######   #   ## #  #  #### ####   #
#      ####  ## ### #  ## #  #### ### #  # # ## ## #  ##   # ###   ## ## #  #  ##  #######       ## # ## ### ## ##    #    # ###
## # #  ##  #####     ########      # ## # #  #######  ## ##   ## ##   #### ## ###      #  # ## ##  ###  #   #   ## # # ## ### #
#### # ####  # ###### #### # #### #####  ####  ##     ##  ############ ##   ##   ## # #   #########   ## # #   #  # # # #      #
#    ####   ##         ##  # # #     ## ##    ##  ###  ##  ##### # # ##### ##  # ## ##### # #   # #####  # # # ## # ###### ### #
## #    ## ##  ## ## #  ##       ## ####### ##### #   ####     #     ##    ## ####   ##       #       #### # #  ###     ##   # #
#  # # ##  ## ### #  # #### ####  #   ##     ##   ## ##### # ### #########  #  #####  ## # # ########## #### # ##### ##  ## ## #
# ## #  ##  ### # ## # #    #    ## #  ## # ##### ##   ##  #        # ###  ## ## ##  ##### ###### #       ## # ##     # ##   # #
# #  ## ### ##    ## # #### ### ######### # ##    ## ##### # # ###### #   ###    ###  # #     #     ## ## ## # ## ## ## #  # # #
# ##  #   ###### ##### ##   ##    ## ###  #  ### ##   ##   # #      # ###   ## #   ## #   ###   # ###   #### # ## ######## # # #
###  #### ### #   ##   #### ## ##      ## ####   ## # #### # ## ###    ## ###### #  #####   ## ##   #######  # ##  ######### ###
### ## #### # # ###  ### ## #  ### # #  # #    # ###### #  # ##   ## # ##      # #####    # ##  # #    ## ####  ##   ## # ##   #
#       ##       ## ##      ##  ## # ## # ## # #  ###     ## ## ###  # ## ######     ## # #  # ####### ##    ## #  #       #####
## ## # #### ## ##  ## ## # #  ##  #  ### #  # # ##   # # #   # #########      #######  # ## ###   ###### ######## # # # #     #
#  #  #    # #   ## ## #### # #######   #### # # #### # # ## ##   ###     # ##     ######  #  #### # ## # #  # #   # # #### ####
##### # # ###### #   # #    #   ##    ###    # # #    # # #  ## # # #### ## ## # #      ## ##  ##     # # # ## ### # #   ##    #
#     # ####     ### #### # # ###  ##  ## #### #### ####### ##  #      # ## ## #### ## ### #####  ## ## # #     #### ###  ######
#### ##    ## ## #   ##   # ### ## ## ##  #    ##   #  ##   ## ## # # ## ## #    ##  # ##        ###  #     # #  ##    # ##### #
#    #  ####  #### #  ## ##     ## #   ## ### ##  # ##    #  # ## ### ##  ### # ### ###### ### #   ##   # # # ## #### ##       #
## # ##    ## #    # ###### ###  # ## ###  ##  ######  #### ## ##   #  ##  ## # ##   ## #   ## #####  ##### ####  ####### # # ##
#  # ## # ##  # ## # ##       # ## ##   ##  ## ##     ##     #  ## ## ####  # # ## # #    # #      ##    ##    ##       # # #  #
############################################################################################################################## #
