# #############################################################################################################
#                 ## #    # # # #  # # ##  ##     ## # # ## # ## # # ##      # #  ##    # #  ####    ##    # ##
## ############# ### ## #         ##    ##  ## ## #      #       #   ## ## #   ##  ####   ##  ##  ##    ####  #
#  ##      # #   # #    ## ######  #### ## #####    ## # ####### ### #########    ## #  ##### ######### # ## ##
## ##### #   ###     ##### ###### ##  # ##  # ### ######     ##   #   ## #  ##### ##   ## ##  # ## ##   # ##  #
#  #     ### #### ######   #      ### #  ## # # # #####  # #    # ###  # ##  ###   ### ##  ## # #   ## ##  # ##
# ## ## ###       #      # ## ### # # # ##  # # ### ##  ######### # ## #  ## #   ###    # ### # ## ##  ### # ##
# ##### #   ## # ### ### #######    # #  ##     ##  ###  ###   #    ## # ##  ###     ##   # #   ## ###  ## #  #
### # #####  # # # #######  ##   ##     ###### ##  ## #### ### #### ## # ###  ### # #### ## ### ## # ##      ##
#   #  #    ###### ##  ####    # ######  # ###  ## ## ## # # # #         # ##  ####### #  # # # ## # #### #####
### ## #########      ## ######### #### ##   ##    ##  #       ###### ##   ### # # # # ##   # # ## # #     ## #
##   #   ### # ### ##     #  ###         ### ### #  ## ####### ##   ###  #     # # # #  ###     ##   #### ### #
#  # ### # # # ##   ##### ##     ##### # # #  #### ##  ##         ###### #####       ##   #### ##  #  #       #
####         #  ###### #     ### #     # # # ## #   ##  ### ## ##  ##  ############# ## # # #  ###### ### #####
###  #######   ## ##     # # #   ## # ##     ## ### ###  ######### ## ##     #  ###  #### # ##  # # # #       #
# ###### #### ##  ############ ########  ###  # ###  ## ## #     # ## ###### ##   ##  ##  #    ##       #######
#  ##          ## # # # #  ####### # ### #### # # ##    #  # # #    #  ##  # ## #  ##  ## ### ######### # #####
## ##### #####      # #   ## ##  # # # ###      #  ####   ######### ## ###   ##### ## ##      # # #  ##       #
#  # #   ########## # ### ##  ## #   # ########   ####  ##### ## #   # # ###   # # #   #### # # # # ##  # # ###
##     # #    ### # # ##   ## ## ### # #  #     #  # ## # ##       #   # #####       #   ####       ### #######
##### #######   #     ### ##  #        ## # ##### ## #  #  ########## ## #   ##### ##### # ########      ##   #
# ### #       #   # #      ## ### # ## ## ###     #  ## # ## # #####       #       #             ### ######## #
#   ############# ##### ##    #######     ##  ### ##                 # # # ## # ###### ## ######   #   #  # # #
### #### ## ## ####     ### #   ## #  ###    ###     # ##### ## # ## ##### ## ###   #######      #   ### ## # #
#   # #          #### ###   ###      ##   # ##   # # ###      #####   ##    ####### # ## #### ######     #    #
### # ######### ## ####   # ###### # ## #####  # # ###### ###### ### #### # ##              # ### ##### ## ####
#      ## # ##       ###### #      # #  #############     ##            #####  # # # # # ## ###    ###        #
###### #     ###### ## #    ##### ## #### # ### ##    ### ## ## ## #### ## ### # # ### ###   ##### # ## ### ###
## ### ## ##   # ## ## ## ###     #  ####        #### #   ####  #  ## ###   ###### #   #### ## ##  #  # # ### #
#    # #######      ##  ###### ## ## #    ###### # ######    ## ####   #  ### ##   ### #        ## ## # #  #  #
####   # # #### ###  ## ##  ######## ## # #  ##  #     #  ####### #### ## # # ###### ##########     # # # ## ##
######          ####     # ## # ## ######### ### ## ##   ##  # #               ## #   # ###   ### #           #
#   ### # # ## ## ### ##   ## # #  ##         #   ##### ####     ### # # # # #    ### #     #  ########## #####
###     # ###  #  #   #  # ## # ##  ####### #   #  #    ## ### ###   # ######### ###  ########              # #
###### ## ##  ###   ###### #  #  ##  #    ### # ##   ####  ##  #   # # ###### ##     ## #      ## ####### ### #
#   ## ######## ### ### ## ##   #### ## #  #  # ########## ## #### ##### # #   ##### ## ############ #        #
## ##  # #  ###     #         ####    #### ## # #        # ##### ###       ### ## #   #  ## # # ##     # ## # #
#   #### ##   ############### ##   ##  ##   ########## #   # # #  ## # # #     #  ### ## #  #      # # # #### #
## ## #   ###                  ####### ### ### #   ### ### # # ##  ########### # ## # ## ## #### # # # #   ## #
## ## # #   ################## # ## ## # # ##  ## ## #####      ##   ## ##       #               # # # ## ##  #
#   # ##### ##  ##       #     # #       # ###    #  ###   ### #### ##   #######   ## # # ###### # ######  ## #
### # ##     ## #  #####   # #     # # #   # #### ## #   # #   ## #  ### # # #   # #  # ####     # ##     ##  #
### #  #### ##  ######   # #### ## ####### # #### ## #########    # ##         # #### #### ## # ##  # # # ### #
#   ## # ## ###  ### ## #####   ## ###            ## # #  ##   ## # ##### ### ## ## ###       ###  ## # #  ## #
# #          #  ## #    ##    # #### ############ ## # ## #  ###     ##   ### ## #   ##### ## ##  ##### ## #  #
####### ## #   ##  # ############ #           #             ####### ##  # #    # # #  ##    #####  ##   ## ## #
###     ######  ## ### # ##    ## ## ## #####   # # # #### ##   #      #### # ## ####    # #### # #### ##  #  #
# ## # ## ##   ##   ##    #### ##    ####     # # ### ####### #   # ## ##   #  ####### # #### #    ##   ## ## #
#    # #     #  ## ##### ## #     ##  ####### ### #   #   #   ## ##  # ### ## #### # # #####    ##  ## #####  #
########## # ##    # # #  # #### ###### #       ##### ###   ###   ## #  ########       ###   ##  ##  #    ### #
# ### # #  # ##### # # ##      #######    # # #### ####   #  ### ##  #### #    ### # # #   # #  #### ### ## # #
#       #### #          #### #### ##   ######### # # ### ## ##    ######    ##     ####### # ##  ##   ## ##   #
####### # ######## ## #  ##    #   #####              ####  #  # ###     # ### ## ### # #  # #  #### ####### ##
### #     # # #    #  ##    ##   #       ## ## # # ##  ##  ### ### ##########   ###       ## ## ## # #   ##   #
#   ## ##   #   # ### ### # ## # ### ### #   ### ##### ##### # ### ###### # ############ #####  ##     #### # #
# #    #  #   # # ##    ###  ### #   #   # ####  ### #         #        #                ###### ### # ### # # #
###### ## ### ### ### ###   ##   # # ## ####    ## # ## # ## # ## # # #   ## ## # #### #  ##      ###     ### #
##     #  ##  #    ####   # #### # # #   ###### #       #  # #  # ### ## ### ###### #### ##  ## # #   ## ######
#  # # ######### #  ##  # #  ######### ### ## ####### ### ################ ### #         ### ## # ## ###      #
## # # #         ## ### # ## # ## # ####               ## ##  ## ##  ##     #    ##### #  ## ## ####   ## # # #
######## # # ### ####   #### #           ### # ### # # ## ###       #######   ######   # ###  # #    # ## ### #
### # #### ####### ########  ## ##########   ###   ### #### ### # #  # #    # #      # # ##  ##### # ####   # #
##         ##   #     ### ########     ##### ##### ##  #     ####### # #### #### # # ###  ##  ## # ###    ### #
#  ## ### ##  #   # #     ##  ## #####   # #   ### ### ##### # # #          ## ### #  ## ##  ##      ## #  ####
# ########### ## ########  ## #  ### ###     # #    ## ##      # #### # # # ## ##  # ##   ##  #### #######    #
### #         #   ###   # ### ## #       # # # ## #  ###### ##        # # ###     ## ## #### ##        ##  # ##
###   ########## ## ###   ##       #### ## # # #  ##  ##    ## ## # ########### # #  #   ##  #### # # ##  #####
# ## ##          #      #  ###### ###   ## # # ## #  ##  ####  ## #### # ## #   #### # #  ##  ##  # #####     #
#  #######################        #   # #  # # ###########    ##  #           # ## # # # ##  #### #   ##  # # #
##  ## # # ## ##     ###   # ## # ### # # ######        ################# # # # #    # #  ##  # ### #  ## # # #
###              ###     # ###  # #   # # ##     ##### ##  #### ###       ### ##### ## # ### ## #   # ####### #
# ######### # ##  ### ## ##### ##### ## ###### # #      ##          # # # ##  ##    ###### # ## ### #      ## #
# ###       # #  ##   ####      ##   ## ## #   ###### #  ### # ## ### ### #########    ##    ##     # # ## ## #
#     # # # ####  ## ##    ### ##  # ## #    # ##  #####     #######  ##  #    #    ###### # ## # ### #  ######
### # # ###   ### ###### # ##  ##### ## ## # #  ## # #   # ####      ##  ## ##   ##   ##   # ## # #   # ### ###
#   ###  ## #  #### #    #####  ##   ## #  ######      # ###    ####  ##  # #  # #  #  ### #### ### # #       #
## ##   ##  # ##      ##  ## ###### ######### # ########  ##### #    ##  ## ####### # ##      # ##### # #######
#  ## # ## ###### # # #####   #     ##          ##       ##     ### #### ## #   #   # ## # ## ### ### #   #   #
## ## # #### ## ##### #     #   ## ##  #### # #  ####### ## # # #   ## # ## # #   ### ## # ## ###     # #   ###
## ## # #          ########### ### ### ##   # ##         ###### ## ##     ##### #  ## ## #  # # #### ## ## ## #
#  #  # ## # # # #   # # # # #   # # ###### #  ## ## ## ##   ## #   ### #  # #### ##   # ## ###      ##  #    #
# ##### #  # ####### # #       #####        #######  #######    ### #   ####   ##  ### #  ####  ## #  # #### ##
####    # ##### ##     ### # #   ##  #### # #  ##### #       ## #   # #   ## #    ##   # ###   ##### ## # #####
#    # ##  ###   #####     #### ##  ##    # ##  #    #### ## #  ### # # #  ##### ##  # # ##  # ## ####      # #
### ##  ## #   #   ##### # #     ## ##### #####   ## #     ### ###  # # # ##      ## # ###  ## ##      # # ## #
#    ##  # ## ## #       # #### ##  # ##  ###### ####### # ### ##  ## # # #  ## # ## #   ## #  ## ## # # # #  #
## # ### ############## ######   ####    ## ##    ##     # #   #  ##  ### ##  ###  ### ###  # ### ## # # #   ##
#  # #   ##               ##   #  ##  # ##     # ##  # # # # # # #### #    ## #   ##     ## #   # ## # # ## ###
########################################################################################################### ###
