# #############################################################################################################
# # # # #                      #   #           #  #  #  ## # #      ## # #   # # #       # ## # # ##  # #  ## #
#         ### # ## # # ####### ### ##### ### #   ## ## ### # # ####        ### # # ## #### #       ##     ##  #
## #### ###   #### ###########     # ###########       # #        ## # # # ###      #   #    # # #  # #####  ##
#######  #### #    ##          # #          #    ## #### # ############# #   # ###### #   # ## # ##      #  ###
#       ##    # # ###### # ######## #######   # ##    #             #  #######      # # # # #### #### ##   ## #
##### # ## ## ### # # ####  ### # # #       # # ## ##   ## #### ## ## ### ## # ###### ### #    #   ##  # #    #
#     ############# # # #  ## # # ####### # # ###   ### ##    #  #  # #      #    ### ############  # #########
#### #### # ### ##      ## ##      #      # #   ## ####  # ##### # ##   ####   #### ### ## ####  ## # # # # ###
#  # #      # #  ## # #     ## ### #### # # # # ##    ## #    ####    ########  ##   ## #       #####   # # # #
## #### ### # ## #### #### ######   #   # # # # ## # ##  # ##    # # ###     ##  ## ##    ## # ###  # #   # # #
## ###  ##       # #  #    #  #   #   ####### #  # ##### #  ## #####     #######  #    ## ###### # ######     #
#    ## #### ###     ### ####   # # ####      ####   ##  # ##   # ## ###  # #  ##   ####### #  # # # #  # # ###
## #    #  ################### ## ###    # ##    # #  # ## ####    #   ##     ##  #           ##       ####   #
#  # # ###  #   ## ## # #  # #######  # ###### ##### ## ##   ## # ### ##  # #### ### ##########  #####  #### ##
## # ### ## ###       # # ##  # ###  ## ##      # #  ##### # ## #####  # ##    ###      # # # ##   ######  #  #
#  # ###        ## ## #    ##       ##  ##### #   ##   ##  ####   ##  ## ## # ####### #        # #    #   ## ##
## ### ########  ###    ##  # #### #### #     #####  #####    ## #### ##  # # #  #  # ##### ##   # ##   #  # ##
#  #   #####    ##   # ####   ###    ## # ###     ##   ##  # ##   ##   # ## #   ## ############ ####  ######  #
######       ## #  #####    # #   ## ######### ####  # ### #  ###### ### ## # # #           # #    ## ##   # ##
#   #  # ### #  ##### #### #### ###  #   #   #    ## #   ### ##  ##   ##  # # #   # # # # ### ## ####    ######
# #   ####   # ####         ##   ## ## #   #   # ###### ##      ##  #  #### # ## ###########   #### ## #### # #
# ## ## #  # ###  # # # # ###  #  ###  ## ### ##  # # ###### # #### ##    ###  ### # # # ##  ####   #####     #
# #  #  ## ###   ########   ## ## #   ### #    ##       ##   # ####### # #####              ###   #       ### #
# ## ##    #####   # #    ####  ##### ##  ## # #  ########## #  ## ##  #    ## ## ## # ## #     # # # ###  ## #
#  ##### # # # ### # ####  ##  ##      ##  ### ##     # # ## ##    ##### ########### ####### ###### # #########
#####    # #   ##     # # #### ## ## # ### #   #  ###     ## ## ##     #         # #    ###       ###    ## ###
##    ## ##### ######      ##  ## #  ### ### # ##  ## # # ## ##  ## # ### # # ##   ## #   ## ####  ### #      #
#  # ######           # # #### #  ## ##   ## #  ##  ### #  # #  #####   ##### ## ########  #   ###   # ### ####
#### ##   ## # ###### # #  ##  # ##   ###    ######   # # #####   ##  #     # #      # ## ## #   ### # ########
###  #  # ## # #      # # ##  ####### #   ## ####   # ###  ##   #### ### # #### # ##   ## #### #   ###        #
# ####### #  ##### ## ###  ##    ## # # # #  #    # #  ## #### ### ### ###    # #  ## ###    #####   ## # ## ##
# # #       ### ## #  #   ### # ##    # # ## # # ## ##  # #              # # ## # ###   ####   #####  # #  # ##
#     # # # ##     # ## # ##  # #  # #### #  ### #  ## ## ### ## # ## ######  # #   # #    # #     # #### ##  #
################ # #  ### ## #######   ## ##  ## # ### ####    # #  ###   ## ## # # ### # ## ### ##### #   ## #
## # # ####   #  # # ###  #  ##      # #   ##  ### ##     ## #########  ####  # # #   # #  #  ##    #  ########
#       # ### # ####   ## ##  ### ## ### # ## ##   ### # ###    # # #  ### ## # # ## ## # ###  ## ### ##      #
####### # # #    ### #### #  ##   ## ##  #### #  #   ###   ## ###     ##   ###### ##### #  ###  ####   # ######
#       # # ## # #      ####  ###  # ###  ##  ##### ##   ###      # #    #     ##     # # ## ##### # #   ### ##
##### #        # ### ####    ##   ####   #### ##    ## #   # # # ## ## # ## # #### ######     ##     # #      #
#   #### ## # #####    ## # ### #  ### #   ##  #### ##### #### # ## ## # ## ### #     ### ## #### #### # # ####
# #      ## # ##    # #######   # ## ### #  ## ##   #     # ######   #####      ### # # ###### #     # # #    #
##### ## ## #  #### #   ##    # # ## ##  # ### #  # ## ##        # #    ## ### ##   #    # ###   # # ### ## # #
#     #  #  ## ##   ######## #### ##    ####   ## # #  #  ## ##### ## # ##   # ## # # ##     # ### #  ##  # # #
##### ## # ########       ## ##   ## # ##    # #  # ## ## #    #####  ################## # #    ## # ### ## # #
# # ######## ### #  # ### ##  ## ##### ########## ###   ### # ##   ##            # ##    # # # #####   ###  # #
#   ### # ##       ## ##  #  ##   ##      ##      #   #  ## #    #### # #### #####  ### #### ####    #  ##### #
# #   # #    # # #  # ### ##  ###  #### ###  ### ## # # ### # ##    ########## ##  ## ### #  ## #######     ###
### #     # ## # # ##  ## ### ### ##      # ##    ##### ##  #### ##### #    ##  ## ##     ##     #    ## ######
####### # ###  # #  ## #### # #    ### # ####### ##      ##  ##    # #   ##  # ###    ## ### # #   ####### ## #
# ## ## # #   ## # ##   ###   ## # #####  ##     ###### ##  ##  ##     ####### ##  ####  ##  # # #    # ##  # #
#       #### ##  # ## ###   #  #####     ######### ##    ##  ## ## ###   # # #    ########## ### ## # # ## ## #
# # # #  ##   ## #  # #   # ##   #### ##  # #       ### #### ## ##   # ###     ##     # # ####    ###    # #  #
### ### #### ##  ## ##### ###  ### ###### # ## # ##        # #  ## ####### ## ##  # #     # ############     ##
#   ##     #  ##  ####    ##  ##            ## ###  ## # ### ## #           # ### ### #####  # ###     # ######
## #### ## ##  ## ## ### ##  ##### ###### #  ####  ##  ###   #  ## ## ### ###  #####      ## # # # ### #      #
#  ##   ###### #  ##      ##  ## ###      # ##    ####   ### ## ##  ####    ####   ## # ###          ### # # ##
## ## #   # ## ##  ## # #### ##   ### ## ##  ### ##    #######   ## ## ## #  ### ######     ## ### ####### # ##
#  #  # #   ###### ## #  ##  ####     #  ## ####### ##     ##  ####     # ##        #### # ##    #      ####  #
# ## ## # #      ###### ####   ## # ### ### #  #    #  # #  ####    # ### ## ## ###    # ##### # # ## #   #####
# #  ## ### ## ###      ## # #### # #     # ## ## # ## # ##   #### #####   #  #   # # ##   ##  #####  # #     #
### ##   ## ##  #### # ##    ##   # ### #####     # ## #  # # #  # # # # # # ## #######  ##### #   ###### #####
#    ## ##  ## ##    # #  ## ### ## #    # ### ## #### # ## # ##       # ### #   #    ##  # ##### ## #  #     #
### ##   ## #   ## # # # ### # ####### #    ## #  ##   #  # ##### # # ##   # # #   # ####    ## #      ##### ##
##  #  #  # ## ##  ### # #     ## ##   # # ######  ## ## ##    #### ###### # # # ##### ### #      # ##    ##  #
#  ### ## ######## ### # # ## ##   # # # # ##     ### ##### ####     # ##### ###   ##    # # ### ##  ## #######
# ###  #       # # #   # ######  #   # ### #  ### #       #    ### #      ##   # #    #### #  ## #####   # ## #
#   ## ## ## ###   ## ## #  #   ## # #   # ###### # ## ## # ## #   # # # ##  # # # # ####### ##      ###   #  #
# # ## ## #    ### ## #####   # #  ### ##### ##   # ##  # #  # ## ######  ## # ### ###     #  ## # ###   #   ##
# # #  ## ## ###    ###     # # # ##   ## #     # # ### ######### # # ## ##  ###       ### ## ## # # ## ## ####
# # ##  #### #### # ##  ## ## ### ## # ##   ## ## #  ##  # # ##       ##  ##   ### # #   #### ## #   ##  #    #
# # #  ##       # # ## #####   ##  ### ### ###### # ####      ## # ####  ##  # ##  # # #    # ## # #  # ## # ##
# # ##  ### # # # ###   ##   # #  ##    ## ##     #   ### # #### #    ##  ## ##### # ### ## ###  # # ## ####  #
# #### ##   #############  ###### #  # ### ###### #####   #  ##  # # ##  ##   # ## # ###  ##########  #   ## ##
###     ###      ##       ##      ## # ##  #         ## # ##  ## # # ###  ###   ## #   # ###  ### ### # ###   #
##  ## ##   # ########## ##  # ## ## #  ## # ## # # ##  #  ##  # ###  ###  ## # #### # #   ## # # # ######### #
#  ### ### ## #   # # ## ### ####  ####  # #  ### ##### ##  ## #  ###  ## ### #  ##  ### #                ##  #
## ##  #   ## # #         #####   ##    #######      ## #  ### ##   ####    # ## ###  ## # ### # # ##### #### #
##### ## #  ### # ### # #  ###  # #### ## # ##### ## #  # ## ###  #    ## # ###   ###  # #  ## # #     # ##   #
#     ##### #   # #   # # ## ## #  #####           # ## #      ## ## # ## #  ## ###   ## # ##### # ### #### # #
##### # # #### ## # # # # #     ####  ### ## #### ##### # # ####  #  #### ####   ### ### #     # #   #####  # #
#           ## ## ### ### ## # ######     ## #      ##  # #    ## # ##       ## ##     ### ####### #  ## #### #
##### ## ## ## ## #    ## ## # ##   # #####  # # ##  ## # # # ##  #  ### # # #  ## ## ####      ## ##       # #
## #   # ## ######### ############# ### #### # # ## ##  # # ##### ###### # # ## ##  ###    #########  ## ## ###
#    # # ##     ##    ## ## # # #    ##      # # #   ## # #    ##   ##   ### #   ##  #####         ##  #  # ###
## #####  # # #  ######           ##    # # ## # # ###  ### ##### ######   # ## ####  #### # ######### # ##   #
##   ##  ## # # ##      # # ## ## ### ##### ## ###   ##   #     # ##     ### ##    ##    # #        ####  ## ##
#  #  ## ## # # #  # ## # # ## #  #   ##     # #   # ## # ## # ##  ## ##   # ## # ##  # ## # ## # #    ##  #  #
############################################################################################################# #
