# #############################################################################################################
#  # #        ## ## #   # ## # ##  ##   #     #  # # # # # # # #   #  # ## #    # # # # # ##  ## ## ## #   #  #
# ## ##### ##    #  ## ## ##    ## #  # # ##### ## #         # ## ## ## ## # #### #     # ###     #  # ### # ##
#     ## ##### #   ###  # #### ### ## ### # ### ##   #########          #           #####  ## ##### ##  ##    #
### ####  # ###### # ##    ##  # # ##  ## # # #  # #  ## ### ### ######## ######### ## ## ##     #   ##  ## ###
# #    ##   # #         ######        ### # # # ## ##  # # #           ##   ########## #     ##### #### ##  ###
#   ###### ## ####### ##### ## #### ###     #      ##### # # #### # ##    #        # # # ###  ###   ##  ###   #
### # # #   # #  #     #          # #######   ## ### # # #      # #  ## # # # ######      ##### ### ## ## # ###
# # # # ### # ## #### ## ### ## ### # ### # ###      # # # ### ## ##  ##### #  ## ## ###### ##         ##     #
# # # #     # ## # #       ######## # #     #### ##### #     ####  ##   ########  #   ## ##  ## ######  #### ##
#   #   # # # ## # ## ####  ## ## ### #####    #   ##    #######  #### ## ## # ## # ###   ##      # #######   #
###   ##### # #       # #####  ##  ##  #    ########## ######  #### #####  # #  # #   ## ### # # ## # # # ### #
##### ## #### #######    ## # ### #### ####     # ##   ##     ## #  # # # ##   ##   #  # # # ###### #   # ##  #
#  #   #  ##   #  ### ####    # #   ## ##   ## ##  ###    #####  # ## #    ## ### #### #      # # #   ###  ## #
## # ### ##### # ##    # # #### # ####  # # ##### ###  # #### ##      # ##### #    # #### ##### # # ### ##  # #
#     ##  ##     #####             ##  ####   # # # # ####  # ### ###    ###  # ####  # # # ##  #    ## ###   #
##### ## #######   ##  # ######### ### # #  ### # # # # ## ##  ## ######## ## #      ##        ## ####  # ### #
#         ## ##  ##### ####     #### #   ##   # # # #       # ##     ## ##      # ## ## ### ####   ##  ## ##  #
######## ### ###   # #  # # ##### #    ###  # # #     ### #      #####  ## ###########   #### #  #### ##     ##
#        # #  ####   ## # # ###     #### # #### # ###  ## # # #### # ## ##  # #  #  ## ### #    ##    ## ## ###
######## # # ## ## ####       ##### ###    # ##    ###  ##### #### # ##  ##     ## ##  #   # ####### #####    #
#   ## # # # ##     ##  ### ### ##    ## ###    ##  ###   #####  # # #  ### ###### ## ## ### # # # # ####  ####
### ## #     ##### ### ######    ## ###   #### ###### ## ##  ### # # # ## #  ### # #  ##   # #     #  ##  ## ##
#        #####  #  ##      #####  # #####  #    # # #  #### ## #   # #      ## # # # ##  ### # ##### ##  ##   #
##### ##  ## ## # #### #####  ###     ##  ## ##   #   ###    # # ### # # ##      #    ##   # # # ##  ### ## ###
## ####  ### #    # #        ##   ###  ##     ###   ### #### # #       #### # ##   # ##  ###      ##  ##  #   #
#  #  ## #     # ## # ###########  #####  # ########### ##       #####    # #  # # # ###     #### ## ####   ###
##   ##    #######      #   ##    ## ### ######   ### # ## #####     # ###############   # #    ###  # #  ### #
####  ### ###  ##### #### ###### ### # #   ## # ### # #        # #######   ##    ####  # # ## #   ## # # ##   #
## ## # # ##  ## #   ##    # # # # # #   #  #   # # # # ##### ##   ##    #  ## ### #  #############  # # ## ###
#          ## #  ###    ####   #     # ###### ### # # # ######### ##  #######  # # # ## #######   ## #   ## # #
### #### ###  # ##   ##   #### # #####   ## # # # #             ###  ### ## ## # # # ##  # ## ## ##  # ####   #
######     ##    ## #######  #   ##  # ###  # # # ## ###############     ## ## #      ##    # #   ##    # ## ##
# #  #### ##  ##### ## ## ##   #  ##    ### #           ### ##  # ## ## ### #    ## #  # #### # ###### ##     #
# ##  ##  ### # ##         ## ###### ## #     ## # # ####    ##       ### # # ##########   #  # #  ##     #####
#  # #### # # # ## ##### ####   ##    #### ##### # # ##   ##  ## #######       ###   # # ### ## # ##### ### # #
##    ##    # #        #####  #### ##  #       #####    #####     # #    ## # ## # ### #  ## ## # ## #        #
### ####### # # ### # ###  ##    #### ## ######## ## # ##   # # #     #########      # # ##  ## #  #   ########
#    #### # # # #######   ##  ##### # ##  ### ##   # # ## ####### # #     ## #  ######    ##  # # ## #### #   #
####  ##    #        #### ###   ##     ## # #    #####       # ############  ## #   ##### #  ## #           ###
# ###  ## #   # ###### #  # ## ### #####      ##### ## # # #          ## ## ##  # ### ##  # ##    #### # ##   #
# # # ##### ### #####  ##   ## ##    # # ########    ### ##############  ##  ##     # ###    ####    # ########
# #   # ##   ##     ## ## ###   ## ###      ### ## #####  # ## ###  ### ##  ##  # ###  ## #####   #######     #
# ### # ## #  ## ##### #  # ###        # #### # ##     ##        # ## # #  ##  ####   ##      ###   # ##  #####
#  ## # ## ####### ##  ##   # # # ## ###           ## #### ## ####  # # ##    ##  ### ## ### ##   ###  ##   # #
# ##  #     # # #  ## ### # # # ######## ############### ####### # ##   ## # ##  ## # ##   # ## ##### ##  ### #
#  ## ## # ##     ##  # ### #       ## #### ## #  ## # #  #  # #      ######  # ### #  # ###### ##  #    ##   #
# ##  #  # #  # #### ## ##  ### #####   ##   # # ##    # ## ##   # ##### ####         ##  # ##   # ## ## ## ###
# ###   #### ######  ##  ## ##   # ### ### ### # #  # ##  # ### ####   # # #### ## ######   ## ###     #      #
#  ### ## #    ## ## #  ##     #    ##     #       ##  ##   # # # ## ###     #   ###   ####        # ### # # ##
## # #  # # #####  # ##    # # # ##### ##### ### ######## ###     ## # #####   ####  ###    #### ####### ######
#  # # ##    ## ##      #### #######   # ##    #####  ##    ### ###     ###  #### ##   ### #######     #### # #
##        # ##  ### ###  ###### #  ### # ## ##       ##  #### # # ### ### # ##     ## ##         ## ##        #
#  ############  ##   #### ## #   ## # #     ##### #  ## ## # # #  #   ## # ## #####     # ## ####   ##########
##  ##    ##  ##  # #### # ##   ###  #   # #  # #######   # #   # ## ###       # #   #####  #      ######### ##
## ##  # #### ###   # #  #  ## ## ##   # ####     # # ## ## # ###        # # #     #     # ##### #            #
#  #  #### #   #### #   ## ##   # #  ############## #  #  # # ### ## # # # #### #### ## ##     ### ######### ##
## # ## #  ### # #    #### ### ##   ### #  # # ###    ## ##        # # # #   ## ####### ## # ####  ## ######  #
## #  # ## ##    ## #### #  #     ###   # ##     # ##### #  # # ############ ##       #  ###    ##         # ##
#    ## ## ##### ##  ##  ## # # #  ####   ## ##### # ##    ####       #  ###  # ## # #####   # ##  ## # # #####
### ##  #   ##   ###  ##  # # ###### #  ###        # ## ####  # # # ### ## ####  ###     #####  ##  ### # #   #
#    # ## ###### # # #### #     ###    ## # #### #           #### #   # ##    ##  #### #   ##  ####   # #   # #
### ## ## # ## # # #   ## # ##### ## ###       #### # ## ######## ### #    ## ###    #### ##  ## ## # #### ####
#   ## ## # ## # # # ####     # #     ## ## ######  #  #    # #   ###   # ##### ## #    ##### #  ####  ##  # ##
###    ##   ##     # ###  ###     # #    ##  # # ############ ## ## ######## ## ############### ## ### ###    #
### #######  #### ##   # ## ## # ## # ##  ##       # #         #### ### ## # #  # # ### # ## ## ##   ### ######
# #   # #   ### #    #       ###### # ## ### #####     ########## # # #      # ##     # #  # #     #  #       #
# # ### ## ## # # ## # ## ## ##   ### ##   #     # # #     ## # # # # # ######    ##### # ## # ## ###   #######
# #  ##  # ## # # #########     # ########## # ######### ###  #          # # # ##  # ##         ### ###       #
# ##  ##   ## #   # # # ###### #### ### ######   ## ###### ## # # # ####       ## ##  # ###########  ##########
# ## ##  ###    #       # #  #   ##          # # #   #  ##  # # ###   ############### # # # # ### ##    #  ## #
#  # ###   ## #### # #### # ######  ### # # ###### ### ### ##    ###### ## ## ##    # # #          # #### ##  #
# ##   ## ##  ######  # #    ### ## # ##### # # ## #   #   ## ##  ## #         #### # # # ## ### #         # ##
#  ## ##  #  ## #######   #### # ##    # #### # ## # ### ###  #####    ## # ##  ##  # #    ####### #######    #
# ###  ## # ##   # ###  #### # # ## ####  ##          #   #  ## ### ############### #   ##       ###    #######
#  #  ##       #     ##      # # #   # # ##  # # ## #   # # ##    #   #  #  # # ##    #  # ### ###### ### ## ##
# ## ##### ##### # #### ######     #        ####  #### ####    #### ### ## ## # ## ###########     #   ## #   #
#  # ##  #     ###### #  # ##  ##### ### ## #  ##   ## # #  ##                           ### ### #   ###    ###
# ##  ## # # #  # ##    ## ## ##  ## ###### # #### ##      ##  ######### ## ## ### #####   #  ######     ##   #
# #  ###   ####      # ##   #    ###      #   ##    ### ##########     #  ###    #  ## ##### ## # ########## ##
# # ## # #### ## # #####  ### ## # ### ## ### #### ##              ########   # ###     #          #### # #####
# # #          # #    ###      #     # ## ##   # ###### ## ## # ##     ## ## ##   # # #   # # ######  # # # # #
# #   # #############     # # ### ############   ## # ###   # #### ###     #### ### # ## ## #   # #  ## #     #
# ## ##   # #      ## ## ## #   #     ## # ### #      #### ## ##    ## # #  # #######  #### # #     ###   #####
# ## ## #     # #######   ####### ###### # # #### # #    #  # ## # ### # ##         ##  # ##### # ### # ###   #
# #   #########      ## #     ##      #      ## ### # # ## ## #  #   ###  ## ### ######      ## #         ### #
# # #### #    # # # ##  ######### ###   # ##    ##### #  ###### ####   # ###  ##    ##  ######  # # ### ###   #
#          # ## # #  ##        ##  ## # #  # ##     # ##  ##      ## # #   ##  ## #  ##     ## ## # ##      # #
############################################################################################################# #
