#.#############################################################################################################
#..#.#........##.##.#...#.## # ##  ##   #     #  # # # # # # # #   #  # ## #    # # # # # ##  ## ## ## #   #  #
#.##.#####.##....#..##.##.##    ## #  # # ##### ## #         # ## ## ## ## # #### #     # ###     #  # ### # ##
#.....##.#####.#...###..#.#### ### ## ### # ### ##   #########          #           #####  ## ##### ##  ##    #
###.####..#.######.#.##....##  # # ##  ## # # #  # #  ## ### ### ######## ######### ## ## ##     #   ##  ## ###
#.#....##...#.#.........######        ### # # # ## ##  # # #           ##   ########## #     ##### #### ##  ###
#...######.##.#######.##### ## #### ###     #      ##### # # #### # ##    #        # # # ###  ###   ##  ###   #
###.#.#.#...#.#  #.....#*         # #######   ## ### # # #      # #  ## # # # ######      ##### ### ## ## # ###
#.#.#.#.###.#.## ####.##,### ## ### # ### # ###      # # # ### ## ##  ##### #  ## ## ###### ##         ##     #
#.#.#.#.....#.## # #.,,,,  ######## # #     #### ##### #     ####  ##   ########  #   ## ##  ## ######  #### ##
#...#...#.#.#.## # ##,####  ## ## ### #####    #   ##    #######  #### ## ## # ## # ###   ##      # #######   #
###...#####.#.#      ,# #####  ##  ##  #    ########## ######  #### #####  # #  # #   ## ### # # ## # # # ### #
#####.##.####.#######,   ## # ### #### ####     # ##   ##     ## #  # # # ##   ##   #  # # # ###### #   # ##  #
#..#.. #..##...#..###,####    # #   ## ##   ## ##  ###    #####  # ## #    ## ### #### #      # # #   ###  ## #
##.#.###.#####.#.##  ,,# # #### # ####  # # ##### ###  # #### ##      # ##### #    # #### ##### # # ### ##  # #
#.....##..##.....#####,            ##  ####   # # # # ####  # ### ###    ###  # ####  # # # ##  #    ## ###   #
#####.##.#######...## ,# ######### ### # #  ### # # # # ## ##  ## ######## ## #      ##        ## ####  # ### #
#.........##.##..#####,####     #### #   ##   # # # #       # ##     ## ##      # ## ## ### ####   ##  ## ##  #
########.###.###...#.#,,# # ##### #    ###  # # #     ### #      #####  ## ###########   #### #  #### ##     ##
#........#.#..####...##,# # ###     #### # #### # ###  ## # # #### # ## ##  # #  #  ## ### #    ##    ## ## ###
########.#.#.##.##.####,      ##### ###    # ##    ###  ##### #### # ##  ##     ## ##  #   # ####### #####    #
#...##.#.#.#.##.....##,,### ### ##    ## ###    ##  ###   #####  # # #  ### ###### ## ## ### # # # # ####  ####
###.##.#.....#####.###,######    ## ###   #### ###### ## ##  ### # # # ## #  ### # #  ##   # #     #  ##  ## ##
#........#####..#..## ,    #####  # #####  #    # # #  #### ## #   # #      ## # # # ##  ### # ##### ##  ##   #
#####.##..##.##.#.####,#####  ###     ##  ## ##   #   ###    # # ### # # ##      #    ##   # # # ##  ### ## ###
##.####..###.#....#.#,,      ##   ###  ##     ###   ### #### # #       #### # ##   # ##  ###      ##  ##  #   #
#..#..##.#.....#.##.#,###########  #####  # ########### ##       #####    # #  # # # ###     #### ## ####   ###
##...##....#######..,,  #   ##    ## ### ######   ### # ## #####     # ###############   # #    ###  # #  ### #
####..###.###..#####,#### ###### ### # #   ## # ### # #        # #######   ##    ####  # # ## #   ## # # ##   #
##.##.#.#.##..##.#  ,##    # # # # # #   #  #   # # # # ##### ##   ##    #  ## ### #  #############  # # ## ###
#......... ##.#..###,   ####   #     # ###### ### # # # ######### ##  #######  # # # ## #######   ## #   ## # #
###.####.###..#.##.,,##   #### # #####   ## # # # #             ###  ### ## ## # # # ##  # ## ## ##  # ####   #
######.....##....##,#######  #   ##  # ###  # # # ## ###############     ## ## #      ##    # #   ##    # ## ##
# #  ####.##..#####,## ## ##   #  ##    ### #           ### ##  # ## ## ### #    ## #  # #### # ###### ##     #
# ##  ##..###.#.##,,       ## ###### ## #     ## # # ####    ##       ### # # ##########   #  # #  ##     #####
#  # ####.#.#.#.##,##### ####   ##    #### ##### # # ##   ##  ## #######       ###   # # ### ## # ##### ### # #
##    ##....#.#,,,,    #####  #### ##  #       #####    #####     # #    ## # ## # ### #  ## ## # ## #        #
### #######.#.#,### # ###  ##    #### ## ######## ## # ##   # # #     #########      # # ##  ## #  #   ########
#    ####.#.#.#,#######   ##  ##### # ##  ### ##   # # ## ####### # #     ## #  ######    ##  # # ## #### #   #
####  ##....#,,,     #### ###   ##     ## # #    #####       # ############  ## #   ##### #  ## #           ###
# ###  ##.#,,,# ###### #  # ## ### #####      ##### ## # # #          ## ## ##  # ### ##  # ##    #### # ##   #
# # # #####,### #####  ##   ## ##    # # ########    ### ##############  ##  ##     # ###    ####    # ########
# #   # ##,, ##     ## ## ###   ## ###      ### ## #####  # ## ###  ### ##  ##  # ###  ## #####   #######     #
# ### # ##,#  ## ##### #  # ###        # #### # ##     ##        # ## # #  ##  ####   ##      ###   # ##  #####
#  ## # ##,####### ##  ##   # # # ## ###           ## #### ## ####  # # ##    ##  ### ## ### ##   ###  ##   # #
# ##  # ,,, # # #  ## ### # # # ######## ############### ####### # ##   ## # ##  ## # ##   # ## ##### ##  ### #
#  ## ##,# ##     ##  # ### #       ## #### ## #  ## # #  #  # #      ######  # ### #  # ###### ##  #    ##   #
# ##  #,,# #  # #### ## ##  ### #####   ##   # # ##    # ## ##   # ##### ####         ##  # ##   # ## ## ## ###
# ### ,,#### ######  ##  ## ##   # ### ### ### # #  # ##  # ### ####   # # #### ## ######   ## ###     #      #
#  ###,## #    ## ## #  ##     #    ##     #       ##  ##   # # # ## ###     #   ###   ####        # ### # # ##
## # #, # # #####  # ##    # # # ##### ##### ### ######## ###     ## # #####   ####  ###    #### ####### ######
#  # #,##    ## ##      #### #######   # ##    #####  ##    ### ###     ###  #### ##   ### #######     #### # #
##,,,,,   # ##  ### ###  ###### #  ### # ## ##       ##  #### # # ### ### # ##     ## ##         ## ##        #
# ,############  ##   #### ## #   ## # #     ##### #  ## ## # # #  #   ## # ## #####     # ## ####   ##########
##, ##    ##  ##  # #### # ##   ###  #   # #  # #######   # #   # ## ###       # #   #####  #      ######### ##
##,##  # #### ###   # #  #  ## ## ##   # ####     # # ## ## # ###        # # #     #     # ##### #            #
# ,#  #### #   #### #   ## ##   # #  ############## #  #  # # ### ## # # # #### #### ## ##     ### ######### ##
##,# ## #  ### # #    #### ### ##   ### #  # # ###    ## ##        # # # #   ## ####### ## # ####  ## ######  #
##,#  # ## ##    ## #### #  #     ###   # ##     # ##### #  # # ############ ##       #  ###    ##         # ##
# ,, ## ## ##### ##  ##  ## # # #  ####   ## ##### # ##    ####       #  ###  # ## # #####   # ##  ## # # #####
###,##  #   ##   ###  ##  # # ###### #  ###        # ## ####  # # # ### ## ####  ###     #####  ##  ### # #   #
#  , # ## ###### # # #### #     ###    ## # #### #           #### #   # ##    ##  #### #   ##  ####   # #   # #
###,## ## # ## # # #   ## # ##### ## ###       #### # ## ######## ### #    ## ###    #### ##  ## ## # #### ####
#  ,## ## # ## # # # ####     # #     ## ## ######  #  #    # #   ###   # ##### ## #    ##### #  ####  ##  # ##
###,   ##   ##     # ###  ###     # #    ##  # # ############ ## ## ######## ## ############### ## ### ###    #
###,#######  #### ##   # ## ## # ## # ##  ##       # #         #### ### ## # #  # # ### # ## ## ##   ### ######
# #,  # #   ### #    #       ###### # ## ### #####     ########## # # #      # ##     # #  # #     #  #       #
# #,### ## ## # # ## # ## ## ##   ### ##   #     # # #     ## # # # # # ######    ##### # ## # ## ###   #######
# #,,##  # ## # # #########     # ########## # ######### ###  #          # # # ##  # ##         ### ###       #
# ##, ##   ## #   # # # ###### #### ### ######   ## ###### ## # # # ####       ## ##  # ###########  ##########
# ##,##  ###    #       # #  #   ##          # # #   #  ##  # # ###   ############### # # # # ### ##    #  ## #
#  #,###   ## #### # #### # ######  ### # # ###### ### ### ##    ###### ## ## ##    # # #          # #### ##  #
# ##,, ## ##  ######  # #    ### ## # ##### # # ## #   #   ## ##  ## #         #### # # # ## ### #         # ##
#  ##,##  #  ## #######   #### # ##    # #### # ## # ### ###  #####    ## # ##  ##  # #    ####### #######    #
# ###, ## # ##   # ###  #### # # ## ####  ##,,,,,,,,,,#   #  ## ### ############### #   ##       ###    #######
#  #,,##       #     ##      # # #,,,# # ##,,# # ## #,, # # ##    #   #  #  # # ##    #  # ### ###### ### ## ##
# ##,##### ##### # #### ######,,,,,#,,,,,,,,####  ####,####,,,,#### ### ## ## # ## ###########     #   ## #   #
#  #,##  #,,,,,###### #  # ##,,##### ### ## #  ##   ##,# #,,##,,,,,,,,,,,,,,,,,,,,,      ### ### #   ###    ###
# ##, ## #,# #,,# ##    ## ##,##  ## ###### # #### ## ,,,,,##  ######### ## ## ###,#####   #  ######     ##   #
# #,,###,,,####,,,,  # ##   #,   ###      #   ##    ### ##########     #  ###    #,,## ##### ## # ########## ##
# #,## #,#### ## #,#####  ###,## # ### ## ### #### ##              ########   # ###,,,,,#,,,,,     #### # #####
# #,#,,,,      # #,,,,###,,,,, #     # ## ##   # ###### ## ## # ##     ## ## ##   # # #,,,# #,######  # # # # #
# #,,,# #############,,,,,# # ### ############   ## # ###   # #### ###     #### ### # ## ## #,,,# #  ## #     #
# ## ##   # #      ## ## ## #   #     ## # ### #      #### ## ##    ## # #  # #######  #### # #,,,  ###   #####
# ## ## #     # #######   ####### ###### # # #### # #    #  # ## # ### # ##         ##  # ##### #,### # ###   #
# #   #########      ## #     ##      #      ## ### # # ## ## #  #   ###  ## ### ######      ## #,,,,,,,  ### #
# # #### #    # # # ##  ######### ###   # ##    ##### #  ###### ####   # ###  ##    ##  ######  # # ###,###,,,#
#          # ## # #  ##        ##  ## # #  # ##     # ##  ##      ## # #   ##  ## #  ##     ## ## # ## ,,,,,#,#
#############################################################################################################,#
