# #############################################################################################################################################
#  # # ## # #      ## ## ## ##    #    # # ## ##  #        ## # ##       ## # # #   # # # #    #  ##  # ##  ## ## # ##    #   #  ## #  # #    #
## # # ## # #### ###   # #  ## ## #### # #  # ###   ########    ### ######  # #   ###   # # #### #### # #  ##  ## #  ### ## ### ##    ## ## ###
#    # #     # #  #### # ## #####      #   ##  ####  # # ##  #### # # #  ## # ### ##### # # ####  ##    # ##  ##    ##       ##  ## #### ##  ##
# ##     ##### ##  ##     #  ## ###### # ###  ## #  ## # #  ####  # # # ##    ##  # ##         ## ## # ##  ##  ## ##### ####### ##  # #  ###  #
##### #### ### ## #######   ##    ## # #   ## ## ##        ##  ##     # ### ##### # #  ### # #### ## #### ####  #   ##      ##   ##   ##  ## ##
#  ## ## # #   ##  ##     ##### ###    # #### #  ## #### #  ##  ### ###  #  # ##      ###### ## #    ## #  ##  ## #### ### ### ###  # #  ##   #
##         # # ## ####### ## #  # #### #  # # ## #     # # ##  ## # ##  ## ##  ## ######  ##    #### ##   #### #       # ####  # #### # ##  ###
###### ####### #    ##       # ## #    # ##   ## # ####### ### ## #  ##     # ##  #      ##### ##       ### ## ## ######  # ##    ##    ## ####
# ## #  #   ## # ####### # #   ## #### #  ### #        ###  ## #    ##  #####  ##   ## #######  ####### ##     ##  ###   ## ### #  #### ##  # #
# #    ## ###  # ## ##   # # #       # # ## # #### ### # ##### ## ##### ##  ##  # ########## ####       ## #####  ## ## ### # ####  ##  ## ## #
# ####  # # ##   #   ############### #   ## #    #  #### ##    #   # #   ## ### #        ##   # ####### ##  ## ##  # #    # # ## # ### ### #  #
# ## # ##   ## ### # #  ####### ## # ###  # ####   ## #   #### ## ## ## ##  # #   ### ####  #   # # ##  ## ##  ## ##   ####            ##    ##
#    #  ## ##   ## ####  # # #     # ##  ## ## # ###  ## ##  #     # ##  ## #   #   #  ####### ## #  ## ##  # ##     #    ##### #### #### #####
#### # ###  ###  #  ##  ##   #### ##  ## ## #  # # # ###  ## #### ##    ##    ### ### ## # #   ## # ##   ##      # # # ####  ## #  #### # ### #
# #    ##  ## ## # #### #### #     # ##       ##   #   ##  # ###   ####  # ########## #    # #  # #  # ###  ############# # ##  # ####  # # # #
# #### ###  # ##    ##   ### ## ## #  ## ## # ####   #### ##   ## ##  ##        ### ##### ##### # # ## # # ######## ####     ##      ## # #   #
# # #    # ## ## ##### ###    ####   ###### ### ## ###    ## ###   ## ## ######## # ## #    # #   # #      ##    #   # #####    ######      ###
#   #### #  # #  ###     ####  ##  #  # ##   ##  #   ### ### ##### ## #      #    # ## ## ### ## ## # ######## ### ### ## ## ##    ###### #   #
## ## ## # ## # ## # ### ##### ###### # ####  ##   #  ## ##  # ##  ## # ###### #### ## ##  #     ## # ##  ## # # # ##  ## ## ####### ## # # ###
#  ##      ## # ## #  ####  ## # ##      # # ### ### ###  ## # ### ##    # # #  ### ##  ## ##### #  # ### ##        ##  # #  # # ### ## # ### #
## ###### ### #    # ## #  ##  # ###### ## # # #   ### # ### # # # ## # ##     ##    ##  #  ## # ##    ## ## ### ###### #   ##        #     # #
#    ##   # # ## # # ## # ##  ##  ## #   # #     ####    ##  # #      #### #####  ###### # ##  # ### ###  #    # # # ## # ###  ### #### ##### #
# ####### # # ## ### ##   ## ##  ##  ## ## # #####  ## #####   ######  # #   ####     ##      ##  ## ####   ######          ## #####          #
#   # # #     ## ##  ####       ####    #     ## ##  #  # #  #### # ##     ### ## #####  ####  ## #  # ## #### ##  ## #######     ## ##########
# ### # # #####   ## # ## #### ## ##### #### ##   ##   ## ## # #    ## ##### #      # # ### ## ## ##            ##  # ##  # # #####      ###  #
#  ##   #       ###  # ##   ####  #     ###   # ###### ## ## # ## ###          ###### ###          ### ## ######## ######      ## ## ##### # ##
# ##### # ####### ##      ### ### #####   # ###   ##   #  #  # #  # # ########## # #  ###### #### ###  ##### # ##   ###   ####    #    ##     #
#  ## # # #     # ##### ### #  ## #   ### # # # ###### ##   ## ##   # # #  ## ## # # ## ## ###    # ##   # #    ###   ### # ####### ####  #####
## ## # #   #####  ##   ##  # ##  # #     # #    # ##   ## ##   ## ## #   ##         ## #   #####   ## ### # ####   ###       ####   # ##   ###
#   # # # # # ##  ##### ## ##  # ###### #   # # ## ### ###  ### ##      #  ## ########  ###  ##   ###    # #    ###   ## ####    ### # #  ### #
### # # # ###  ## ##     # ## ##   ## #### ## ####  ## # # ## # #  # # #####    ## # ## ##  #### ## # ##     # ## # #### #  ## ####    # ## # #
#     # # ##  ##   #####   ##  ## ##  ## # ##  ##  ##    #  # #   ###### #   # ##  # ## #  ##  # ##    ##########    ##    ######   #### ## # #
#####      ## ## ###   ## ####       ##     ##  ##  #### ##     ### ##   # ####### # ## ##  ## # ## ####  # ##  ####    # ## ## ###           #
## ### #####  ##  ## ###   # # #####  ##### ## ##  ##  # ## ###   #  ## ##  # # ## # #  ## ##    ## #  ## #  ## ###  # ## ## ## # ## ##########
#         ## ####  # # ###   #####   ##     ##  ##  ## # #  ####### ###  # ## # ##   ## ##    ##### # ##    ### # ## ######  ## #          #  #
###### ##    #  ## # # # # ###   ### ######  ## ###  # # ## #   ##    ##    # #    #### ### ###  #       #### #   #   #  ## ### # # ######## ##
#  ##  ####### ##    # # #   ### ##   # # # ##   ## ## #      #### ####  #### ## ####   #     ##   ## ######    # # ### ##  ##  # ### ## ##   #
## ## ## ####  #### ##   # ### # #### # #   ## ###   # ## ##### #  ## ## # #   #    ###   ### ## ######    ## #####  #   ##  ##    ##  #  # ###
#  ##  #      ##     ## ## ##  # # #  # ### #   ####   ## ### # # ##  ##   ### # #####  ### ###     ##  ####  ###   ## ###  ### ###### # ## # #
## ###   ######### # #      ##     ##     # # ###    ###  # #      ## ## ### #     ##  ###   #  ###### ## ### # ### #  # ## # # #   ## # #    #
#   ## ###    # #  ####### ####### ###### # #   #### # ##     ######  ##  #  ### #####   ## ## #### #   #  ##    ## # ##    # # # ###      ####
###     ## #### # ###       # #  # # #  #   # ###         # #   ## # ### ## ## #   ##  ####     # # # ### ### ####  #  # #### # # # # # ##### #
###### ##  ## #   # ###### ## ## # # ## ### #   #### # ##########  # ##      # # ##### ##   ##### # # ###  #    ## ## ## ##           ###   # #
#       ##  # ## ## ##      #  # # #  #  ## # ###  ###  # ## ## ## #  ######      ##    ## ##  ##       ##   #####     #    # # # # #  ## ### #
## ####    ## ##  # ####### ## # # ## # ##      # ##   ## #   # ## # ##  # # ######### ### #  ##  # # ##### ###  ## #### ############ ##    # #
#### ## #####  ##   # ##    ## # # ##    # # # ## #### ## ## ##  # # ###     # # # ##  ##  # ### ######## #  #  ##         ### # #  ##### ### #
# #     ### # ##  ### #####      #  ### #### ####  ##  ##    ## ## # # #####   #    # #### # # # # # #    ## # ### #######  #      ##  #  # # #
#   ### # # # ## ## #  #  #### #   ##    ##   # # ####    ## ##  # # # ##    ### #### #        #     #### #  # # #  ### ##### ### #### ##     #
#####     #    #    ##   ## ##### ##### #### ## #  # ### ###### ##      ####  ##  # # # ## # ### # ###  # ## # # # ## # # # # ##### #  #  #####
## ###### # #### ###### ##    ##   ##    ##     # ##  #  # ##      ## ### ## ##  ##     ###### # ### ## # ## # # #                # ## # ### ##
#   ###     # ##   # #  #####  ###  #### #  # # #  ## ##    ## ########    # ###    # ###  ##     ##      ##   #   ### ## # ####### #  #      #
### # ### ### ## ### ##  ## ## #   ###     ###### ##  ## ####  #  ## #### ## # # ###### # #### ##  ### ###### ## #############  # # ## # ######
#     ##   #  ## # # ## ##  #    ### #### ## # #  ###     # ## # ##   ##     # #   # ## #  ##   # ##    ## #  ## #    #    # ## #           ###
# # #    ### ### # # ##  ## ####  ## # #  ## # # ## ## #### ##      #  #####     ### ## # ##  ######## ### ## ##   ## # #### #  # ### # # #   #
######## # # # # #      ##     # ##      ##         ##   ## ### ######### ## #####         ## # ## # # # # #   # ######  # # # ##  ###### # # #
#  #     # # #   ## ######## # #  ###### ###### #####  #### # # ##   ## # ##  ## # ###### ##  #  # # # # # ### # # # ## ##   #  # ## # #### ###
## ##### #     ###    # ##   # # ##       # ###  #  ## ## # #      # #  # ###  #    # #######   ##         # # #   #       #   ## #      ## ###
#        ## #### ## ### ###### #  ###### ## # # ## ##   # #   ### ##### #  ### # #### # ###   ###### ####### #   #   ###########    # ##  # # #
##### ## #    ## ##  ##  # ##    ##  ###  # # #     ###   # #  #### ### ##  ## # # ## # # ### ###    # ###     #######   ## ## ## ########### #
## ##### ### ### ## #### # #  ##    ##   ##     ####### #   #### ##  #   ## ##      # # # ##    # ##   # ### #### # ## ###   # ##  # # ## ##  #
#   ## #       #  #  ##  # ##### ####### ## # #  #  # #####  #    ## ### ## ### #####   # ## ######  ###  ## ##      #   # #      ## # #   ## #
## ##  ## ## # # ## ####    ## # ## ## #  ###### # ##  ###  ## ####  #   ## # #  ##   ###    ## ##  ## # ##     ####   #   # ####    # # ###  #
#     ########   ##  # ## ###  # ##      #####      ##  #  ##     ## ## ##  # ##    ### ## ###  ## ##       ###    # #### ####  ######       ##
#####  ##   ####  # ## #  ##  ##  ### ####  #  ####  ## # ##  #####  ## #  ##  # #####  #   ## ##  #  ### #  ########## ### ###  ### ## ####  #
## #  ##  #  # # ##  # ## ## #### ##  #  ## ## #  # ##    ### ## ###  # ## ## ## ##  ## ## ##   ##   #########   ## # # ##   ### # # ##   #####
#    ### ###        ##  # #  # ## ###   ##  #####   ##### # #      ##   #     ##    ##  ## ## ###### ##  # #   #         ## ## #      # ### # #
#### # ######### ##  ## # # ##  # # ###  ##  ## ###  # ##     ######### # ###### ####  ##  #   # ### ## ##   # # ### ###  # ## # ####     # # #
# #  #  # ## # ##### #  # #  ##       ##  # ##  ##  ##  ## ####  # # ## #  # ##     ##  ## # ### # #       # # ####    #### #     ##### ### # #
# ## # ## #    ## ##   ##   ####### ###  ## #  #### ## ##  #    ##      # ##  ## ##### ##  #  ## # # ### # ###    # ##    # ## ##     # ### # #
# ##   ## ## ####  # # #  #  # #  # # # ##  # ### #     ##   ########## # ## ##   ## #  ## # ### # #   # ###   # ####  #### ##  # # # ### #   #
#  # #        # ## ### # ### # ## #   #  ## # ##  #### ##  ### ##  #  # #     ## ##  ##  # #         # #  ### #### #####  #  # #########    # #
## #### # ## ## ##  #     #### ## ###   ##  # ## ### #  ## # #  ## ## # ## ####   ## #  ## ## # ### ####### ######  # #  ## ##   # # # # ## ###
#   ########  # ### #### ## ## ##  #  ##### # ## ##  # ##    # ##  ##       # ### ## # ##     # ###   # ##  ## # ## # ## ##    #   # # # ######
###  # # # ## # # # #    ## ##  ## # ## ##  #  #  ## #  # ####  # ##### #####  ## ##    ## ###### ##### ## ##  # #    ## #  ########       #  #
####                #### ##  ## ##   ##  ## # ## ##  ##     ## ##  ##         ### ### ###    # ##  ## #       ## # ####  # ## # # ## #####   ##
# ######## # ### ## # #  ## ##   ###  ##  # #  #  ##  ## ####     ##  ##### ###    ##  ### ###  # ###   ########    # ##               ### #  #
# # ###    # #####  # ## ##    ### # #### # ## # ### ##    ## ### #  ## ######### ####  ## # ## #   ## ## ## ##  #### #  ############### ######
#     ### #### #### # #   ####  ##     ##    # # #    ## ###  ######      ##  ###  # # ##         #     # #   ## #### ##           ### # ## ###
#####  ####### # #    # #### ## #  ## ######   # ## #### #   ## ## # # ######     ## # ## ## # # ## # ### # ###     # ## ###### #### #        #
###### # # # #     ## # ## # ## # ###### ### ###  # ###  # #### ##   #### ##  #####  # ## ########### ##  #   ## #### ## ##########    ########
#   #    # # ##### #     # # #     # ##  #     ##   # # ##  # # #  #### #  ##  ## ## # ##     # # ###  ##   ###  # ## ##       ## # ####      #
###   ##           ## ##     ##### #  ##   ######## # # #  ## # ##  #     ##  ##  ## #    #####     ##### ##### ## ## ## #####           ######
# ## ### ### # ## ######### ## ##  ##  ## ###  # #  # # ##  # # ## ## #######  ## ## # ##### ## ###### #            #       ## ##### ## ##### #
# #### ############# ##           ##  ###   ## # ##     ###      #  #   ##  # ##             #  #    # # ##########   ## # ##     ##  #       #
# # ## ### ## # ##    ### ## # ## #  ###  ###  #  ## #### # ###### ## ##### # ## ### # ####### ## ####          ############## ##### ### #### #
#    # # # #    #  ##      #####    ## ## # ## # ##  ###      ## # ##  # ##   #  ####### ## #        ## ### ##### ### # # # ######    ##   ####
#### # # # ####   #### ## ### ##### ##  # # ##   ###   ## # ###  # ## ##  ### ##   ####       ### # ### # ####                   # # ### #  ###
#           # ##### ####  #         ## ## #    #  #### #  ###### # #     ## #    ### #  # ########### #    # ## ####################   # ##   #
# ## # #### # #  ##  ############## #  ##   # ##### ##   ##   ## #   ###### ## ###     ###### # ## #    #### #                   ### # #  # ###
########      ## ### #   #     # ## ##  ## #####       #  ###  # ## ##  # # #    # ######## # # ##   ##        # ###### ###### # # ###### #   #
#   # #### ##      # ### #####       ## ## # # ### ## ##### ## #  # ### # # # # ##  # # # #        #  ## ### ###     ##  # # ##### ## # ### ###
# #        ### ###     #  ## ###### ##  #      # ###    ##  ## ##           # ###  ## # # # ################ ##### #  ##        ## #     #### #
#### ####### ###### ##   ##          ## ## ### #  #  ##    ### ## ###########  ## ##              #### ### #   ### # ### # #######   ##### ## #
## ###### #      ## #  # ### # # # #        ##### # ######## # #    #   ##  # ##     # # ########  #       # #   ##### ###     # ## ## # # #  #
#   #     ###### ## ## #     # # # ## #####   ##      ###  # # # #### #####      # # ###       ##### #### ## # ######    # #####  # #        ##
### #####           ## ## # ## # ###### #####  #### ### ## # # #  # #  # ### #######   ######### # #    # ####   # #  ######## ## # # #########
### ### ##### ## ##  ###  ######### #         ## ## ### #  # # # ## # ## #   #     ## ######         # ##    ###     ### ##  # ## # #  ## # # #
#     #       ####  #####  ##       #### # ##    ##   # ## # #    # #  # # ### ## ######     ## # # ################## # ## ##  # # # ###     #
## ## #########    ##  ############      # ## ##    ### #  # # #### # ## # # # #### ## # ##########   #  ###    ###  # #  #  ## # #       ## ##
##### # # ####  # ####      ### # #################  ## ## #        # #         ##         # # # #### # ## ## ### ## #   ## ##      # #####   #
##        #    #####   # ##         # # ##   # #    ### ##   ########   #######    # # # #          # #  # #         # ####  ## ### #  ########
#  # ## #   # ##   ## ## #  # ## ##     #### # ####     ## ###  # ##  #       ### ## # # ## ### ##### # ##   ## # ##    # # ##   #####        #
## # #  # # # #### ########## #  #  # #        # ######      ## # #  ########   ######## ##   ###  ####    # ##########        ### # ###### ###
#  # ## # # # # #  # # ##     # ### #### # # #          # ##### # # ## # ######### ##### ## #   ##  ##  # #### # ## ######### ####    ## #### #
## # #  ####### ##   # ##### ########    ### # # ### # ## # # #                      # #### # # #  ##  #### ## # ## #  # #  # #  # ####    #  #
#  ####### # ##    #     ##### # # ### # ####### #   # ##       # # ##### ## #### ####    ####### #### #### ##    # # ## # #### ##  ### #### ##
# ###           ## #### ##  ##       ##### ###   ## ## ## # ### # #  ######### #### #  ## ## # #        #      ##   # #      ##  # ## #       #
### ## ## ### # ####     # ######### #  #  # #####  #  #  ####### ##      #      #    ###        ## # #   # # ##  #     ####### ##    # ## ####
#   #   #########    # #    ##       ## ##         ### ##       #  ## # #   ###### #### # # ### ######## ## #  # ## # #      #     ##    ###  #
### ######   #  ######### #  ### ###     ## # ## # #   #  ## ##############          #  # ###        ##  ## # ## ## # ## # ### ###  # ##  ## ##
#       #  #   ## ### ##  ##     ##  # #    #  ######### ##    #      ## ##### # # #   ####### ## # #### ## #########  ###       # ## ###     #
# ## ##   ### ##         ##### #  ## #### # # ##  # #### ### #   ## #        #########       ######### ###   ## ##  ##   ## #########  ##### ##
# #  ## ###   #  ## # # ##     # #####    ###  ##          # ## ##  # # ## #  # # # ##### ## ##    ##   ## #       ##### ##    ## # #### ######
#############   ##  ### ## ### # ## ##### ##  ##### # # # ## ##  ## #########          ## ## ## ##    ###  # # ## ######  ## #       ##       #
## ### ## ##  # #  ##    ###   # #         ##### #  ### #  #  # ###      ## # #################  ## ####  ## #  ### ## ##  ### ## ##    #######
#    # #   ## # ##  #### #### ## #### ### ####   ##  ## ## ## #   ## ###    ####### ###         ###### ########        ### ##  ## ## ## ## # ##
# ##     #    # #  ##    #     # #    #   ##   #    ##  ##  # # # ##   # ##             ## # ##             ##  # # ##   #  ## ##  #  #       #
############################################################################################################################################# #
