# #############################################################################################################
#     # #   # # #      ##  ## ##  # #     # # #  #  # # ## ##    ##    # #### # #  ## ## #    # # # # ## #  # #
### ### ### # # # ####### ###  ## #   ##### # ## ##   #     ### ##  ####  ##      ### #    ####       ## ## # #
# # # # # #     #  # # #    ##  # # ### ##    #  #### ## ##  #   ##   ## ### ###### #   # ##### #######  ##   #
#     # # ##### ##     ## #####      ## ##### # ##       ##### #### ####  #      ## ## ##     # ## ###  ##  # #
# # # # # ## #   # ## ### #  ### #####    # #   ###### ### ##  #  # ## ##   #######     ## ##      # # ### ####
##### # # ##   #    ####    ##     # ####   ## ##      ##   ##   ## #  ### ###  # ### ######## # ### #  #  # ##
## #       ##### # ### ## ####### ##  #### ##   ###### ## #  ## ##  # ## # # ## # # #     # ######## # ## ##  #
#  #### ####  #  ### # #   ## #   ## ##  #  ### # ##    # #####  ## # #  # # ## # #   ##### #   ## #   ## #  ##
## ## # #  ## ##  ## #   ###  ###     ## ## # #    ####    ## ## ## # # ## #  #   ## ###    # #### ### ## # ###
#   #   # ##   # ##  ## ## # ## #####  # ## # ### ### # ##### ## ##   # ## ##   ####     ####   #   ## ## # # #
### ###    ###    ## #  ##   ## ## ## ## #  # ##  ##  #  ## # #  ## ###  # ## #### # ###### # ### # #  ##     #
##    ### ## ####  #   ### #### ##       ## #  ##  ## # ###     ##  # ## # #  ##          # # ##  ### ### #####
#  ####       #### ## ###   ##   #### ####    ##  ##      #### #### # #  # ##    ########## #  ##  ## ##  ## ##
## ## ## # ## #  # #    ## ##  ####    # #### ### ## ###### ## # ## # # ##    #### ## ## ## # ##  ##   ##     #
#      #####  ## # ## ###  ### #  #### # # ##        #   ## ## # ##      ## #             # #  ##    #### #####
#### # ## ###       # # ##  ## # ##         ######## # ###  ##   ## ######  # ##### ####### # ###### ###   ## #
#### ####   ####### # # ## ##  #  ##### # # ##          ## #####    #  # ####    ######## # # ## #     ## ### #
#    ##   ##### #   #    # ### # ### #  ######## #### ###   ##   #### ##  ##  ##  ##      #    # ### #### ##  #
# ##  ###  ##   ### ## ###  ##   ##  ##  #   ##### ## # ## ### ### ## ## ##  ######  # ## # #### #    # #  # ##
#  ##   ##  ### # #    # # ##### ### ## ## ### ##       ##  #   ##        ## # ##   ####### # ## # #### ##    #
# #### ####  #    ### ## #  # #  # # ##  #  ## ######## ## ## ##### ## ## #       #     ### # ##    ###  ## ###
#### #  # ##   ##   # #  ##   ##     ## ## ##  # # ###  ## ##  # ## ####### ############# #   ## # ##   ##    #
#      ## #  #  ### # # ### ##### ## #  ## ## ##     ##  #  # ## ##   ## ##         ## ##   ###  ###### ## ####
## ###    ## #####       #  ##  ###  # ### ## #### #####   ## #  ## ####  ## ###### #   ###  ### ###    ##    #
#  #   # ### ## #  ##### ##  ## #### #   # #  # ##  ##   ###    ##  ###  ##    #  # # ####  ## #   ####  # ####
######## ##  #    ##      ## #  # #    ### ## # ###  ###  ## ######   ## ### ### #### # #  ##    ### #  ## # ##
# # ###   ## ### ######## #    ## # ####   ## # # ## # ## ##   # #  ###   #    #  ##  # # ##### ###  ## ## #  #
# # # ### ######## # # ## ####         ## ##  # # ## # #  ## ### # ## ###   #### ####      ## #   ## #   # # ##
#          ### #     # ##  ##  ## ####### ### # #    # # ###  ##      ##  #  ##   # # ## #    # ###  ### #    #
## ## # ## # # ##### # ###  ####    ##  #  ## # #### # # #   ### ######  ######## #    ### ####   ## ##  # ## #
####  # #    # #     # # ## ##### # #  ## ##    ## # #   # ###   #### # #### ## # # #########   #### ###   ####
# #  ####### # ##### #   ## #     #### #  ## # ##    ## ## # ## ##  # # # #   # #   #  # ## ## ##  # #   #    #
# #####        ##      ###  #####  ##  ## #  #  ####     # #     ##       ## ## # ### ## ## ##  ## # # ########
#  ## ########  ###### # ## ##    #### ## # #####  #### ## # ####### ######  #  # # # ##     ## ##            #
# ##     ## ## ## ###        # ## ## # ##    ## ## # #   #      # ## # ## ## ##   #    # #####  #### ##########
# ######    #     # ###### ###### ## #    ####       ### # ###### ##      ##    ### #### #   ## #  #   ## #####
#     #####   # #   ### ##  # #        ##### ## ## #  ## #     ## #  # ######## ##         ####   ## ###      #
## ##  ## ## ###### # #  # ## ### ####   ##  ######## #    #####  # #### ##  #   ## ######  # ###  #  #  # ## #
######     ###    #   ## #  # # ###    #### ## # ##     # ## # # ## # ##  ## # ###       # ## ##  ## ## ## ####
#    # ###  ##### ###  # ## # # ###### ## # #  #  ##### ####     #     ## #  # # # #########     ##   # #### ##
#### ### ## #  #  # ## #  #   #   ## # ## # ## ##  ## # ## # ##### #####  ## # #          ### ##  ## ##  ##   #
## # ##  ## ## ## # ## ## ### # ###     # # #   ##  # #  #     ##    # ## #  # # # # # #### #  ####   # ### ###
#       ##   # #           ##     ##### # # # # ### # ## # ## ### ## #  # # ## # ######## # # ##  ###         #
#######  ###   ## ## # ### ## #####     # # ### #   # #     ### # #####     ##    # # ##  #    ##   # # # #####
## ## ## # ### ## ######   #     ###### # # ##  ### # ## #####  # # # ## ##### ####   ## ## ####### # #####   #
#      # #     #### # ####   ##### ## #      # ## # # ## # # ##   # #    ##     #   ###  ##    # #  #   ##  ###
#### #     ### # #    # ####  ## #      ## #          ##        #     ####### ### ###   ##  #### ##   ##### # #
## #########   # #### # # ## ##  ######### ### ## # ##### ######### ### # #   ##  ##  ##### #    ## ###  ##   #
#  ##  ####### # # ##   #  #  # ##  ## # ####  ####  # #   ##   ######    ###  ## #  ### #    ####    ## #  ###
## #  ##    #       ### ## ## # ## ##       ## #    ## # #### ###  # # ##  ###  # # ## # # ##### ## #### # ## #
#    ###### ## #### #         # ##  #### ########## ##      # # ## # # ##### # ##    # #       # ##  ##       #
# ## ##  ## #### #  ######### # ## ##     ##  # # #    ### ##   ## # # # ##    ## ####   ####### ## #### # # ##
# #  ### ##  ##  ## ###   ### #  # ######  ##       # ####### #### # #    #### #  ## ## ####  ## #   # # ###  #
####  ## ### #  ##    ## ##     ##  ##  ##  ## #### #  #  ##   ##  # # #### ## # ##  ##      ### # ###   ######
## ##  # #     ###### #   ## ## ## ### ##  ##### #### ## #### #### # #    # #  #  ## ## ###### #     # ### ## #
#   ## # ##### # ##   ###    #  ##  #  ### ####    ##     ##  #### # # #### ## # ### ##  #   #   ###          #
### #  # #   #    ###  ########    ## ##    ##  # ##  #######  ##        ## ## # ##  ## ## ### #   ####### ## #
#   # ## ### # #### ## # ## # #### #   ## ####### ## ##  # ## ### ##### ### ## #  ## #      #  # #  ###########
### #    #       ##       # # ##     ###   ##  #  ##  ## # #  # #  ###### #  #   ##    ## #   #####        # ##
#   #### #### ####  # ### # # #  ###  ####  ## # ####    # ## #   ##   ##   ## ##### # ##### ## ##  ########  #
### ## # #       #######      #### ##  ##  ##  # ## #### #      #    ###  # ## #  ## ###   ###  ###          ##
# # #    ## ###### # # ## #######  #  ####  ##   ## ## #   # # ######### ####    ##   ## ####  ## #### #### ###
#   ####  #  ## #  #          # ## # ### # ##  # ## #  # ####### ##  #      ### ##  ###       ### ####  # ### #
###  #### # ##  ## ####### ####      ##  #  #### #  ## #     ###    ## ###### #  ## # # ## ## #      ##    ## #
### ##      ## ##  #          # #### ## ## ## #  ## ##   ##### # #####  ### # # ##       ###### ### ########  #
#    ###### ## ### ####### ######           # ## #  #### #  ##   ### ##   # # #  ## ########### # #### ##  ## #
#### # ###       # ## ## #  ## #  ######### # #  # ##  #   ##  #     ## ### #   ##  ## # # ## # #  # #  ## ## #
#          ##### # #  #    ### ## ## ##       ## # ### # #### #### ###   ##   #  ##        ##   ##   # ###  # #
#### ####### ### # ## ## # ##   ###  ###### ###  # # # #  # #   #####  ###  ######  ########  #### ### # # ## #
#    ##               ####  ## ##   ## ##   # ## # # # # ## # ### # # ##   ### # ## # # ## ##        # # #    #
######## # # ## ## ##  ##  ##   ###    #### # #    # # # ##     # # #    ### # # #       # ## ### # ## # # ####
#  ### ###############  ##  ### #   #### ## # ####     #  # #####   # #####  # #   ####### ##   ### ## # #    #
##     ## # ## # ##  ##  # ## #   #  # #       #   # ### ##     ### # #   ## # ## ###         #   # ## # # ####
### ##            ##  ##    # ######   ####### # ###  ## ## #####     # ###       #   ###############  #      #
#   #  ##### ## #    ##### ## ##  ####   ####  # #   ### ##    ### # ## # ## ###### #####  ### #  ##  ## ######
### #####    #  ## #       #     ## ## ###    ###### # #  # #### # ####   ##  ## ## # # ##       ####      # ##
#   ### ############# ####   # #     # # #### # ## #     ##   #  #  # ###  ##           ## ####### #  # ##    #
#####    #     ##  ######  # ### ### # #  # # # #  ##### ## ### ## ## # # ##  ### ## ##              ####  # ##
## ##### #### ##  ## #    ########     ## # # # ## #     #      ## #       ## ############## ## ## # #  #######
#    # #  ##     ##    # ##      ##### ## # #   ## #####   ######    ### #         ### #######  ## #   #### # #
## #   ## #  # #    ## ######## ## #    # # ###  # ## ## ###### # ######## # ## # ## #      ## ##### #        #
######    ## # ## # #  ## ##    ##   ## #     ##    #    # #       ###   # # ####      ## #  # #  ## # ########
# ##### #  #############   #### #### ## #####  #### ####     ## ##     ### #    ## # #  ######   ##### ## #####
#  #  ### ### ## # # ##  # # #     ###   #  ## ##   # #  # #  #### # #   ##### ########      #####   ####     #
## # ###                ## #   ## ######   ##   ### # # ######## # # # #### ##     ## # ######  #  #### # #####
#    # ## ## ## # # # ###    # #         # #### # #   #   # ###  # # #       # # #    #    # ## # ### # # # # #
## #      #  #  # # # #   # ## ## # # # ##          #   #       ## # # # # # # # # ## # ##                    #
############################################################################################################# #
