# ##############################################################################################################################
#     ##     # ## ##  ## #    #   # ##       ## ##   ## #   ## #   ## ##  # # # # ##   ##  # #  # # ## # # ##   # # # # # #  # #
##### ######    # ## ### # ## ###    ### #####   ## ##  ###      ###   # ## # #   ### #### # ##      #        ### # # # # # ## #
## #    ###  ##   ## # # ###   ## ## #    ## ## ###    ## ##### ##   ###        # #    # # # ## ###### #### # #     # # #      #
#  ### ## # ### ###  # #  #  # ##### ####  # ##   #### ## ## ## #  ###   # ## ####### ## # # ##    ##   # ####### ### #   ######
##  ## ## ### #   ##   ## ####   # # # ## ## ## #### # #  ##      ## ## ######## ## # ## # # ## ####  ###   ## ##  ## # ###    #
#  ##   #  #  # ###### ## ###### # # # ## #  ##  ##  # ## #### ####   #   # ##    # # #    #  #    ##  ## ###   # ##        ####
## #### ## ## # # # #        #            # ### ####   ##       ### ### ### #####     #### # ## ####  ##  # ### # ## ## # # ## #
#    ## ##      # # ### #### ### ######## # # # #  ## ##  # ###   #  #  ###   ##  #######       # ###  ##    ## # ## ######    #
### ### #######   #  #####    #####       # # # # ##  ########  ### ## ## ## ### #####  ##### ###  ## ##  ## ##        # #######
#   # # # ## ### ## ## # ## ### # ####### #   # # ### # ## # ##  ## ##  # #   #   #  ##  ##     ## #     #####  # ## ###   #####
###          #    # ## # #  ### # ### #   ## ##    ## # ## # ## ##  #  ## # ### ### #### #### ###    ###  # #  ## ##     ###   #
# ## ####### ## #   ##     ##         ### ##  # ##### # #  # #   ## ## ##   ##   ## ## #  # # # # #### #### # ####### #### ## ##
# #### # #    #####  #### ########### ### ## ##  ## #   ##   ###  # ## #  #### ####  # # ##        ##   # #      # ######  ##  #
# # #  # # ##  #  ## #    # ##   #    # # ## ###    # #  # ###### # ## # ####  ##   ##    # #### ##### ## # ###### #  # # ### ##
# # ##   #### ## ##  # ####  ### ## #        # ### ##### # # # #    ##   ## # ##  #### ##   ## ####  #         # # # ##    #   #
# #  ###  #       ## # #    ##   ####### ##### ### # #   # # # # # ##  #      ###  # ##### ###  # ## # ##### # # # #  ####   # #
# # ## ## ##### ####   # #######   #   # # ##        ### # # # ### ### # ###### ##    ## #   ##   ##    # #### #   ## # #  #####
# # #           # #  ### ##  # ### ### #    # ## # ###   # #    ##   # ### ##      ##### ## ##  #### ##     ##### ##    ## # ###
#   ########### #   ###   ## #         # ## # ###### ### # ####  ## ##  #   ### #####  # ## ### #     ### #  ## # #  ##### # # #
## ### ##     # ###   ## ### ######### # ####   # #  #     ###  ##  ## ## ### # # # # ## ## # #   # ########  # # ## ##      # #
#  ##   #####   #### ##  # # ##          # ## ### ## ##### # ## ###    #   ##   # #      ##     ######     ## # # ## ##### ### #
## #  ###  #### # ##    ## #  ### ### ## # ## # # ## ##      ## # # #### ######   # ####### ### ## # # ########   ##  ##   ### #
#    ## # ##  #   ### ###    ## ########      # #  # #######      # # #    ## ## ##   ## #    #      # #   # ### ##  ##### # # #
# ##      ### ## ##    ##### ## ##  ## ## # ### ## #  # #  ###### #     # ##     ## ###    ## # ## #     ###  ##  ##   ##  # # #
##### ###  ## ## #### ## # # ##  ## #     #     #    ##   ##    #   # ####### # ##  # # #########  ## # ## # #### ## # #  ##   #
###   #   ##       #   # #   ###  # ######## ## # ###### ###### ## ####  ## ###    ## # #    #  ##  ### ## # # #  ## ####    ###
# ### # #  # ##### ###   # ### ## # # # #  #### #  ##    ## #   ## # ## ##  ##  ## ##     # ## ####   ###  # # # ##   ##  ######
#   ##### #####  # #   ### # #      # # ## #  # # ###### ## ### #        ## #  ### ## ## ## ##    ########        ### ## ####  #
# #### #  # # ## # ### #     ### ##      # ##       ## #  # # # ### ######  ##   ###   ####### ######   ## ##### ###  ##    ## #
# # #    ##   #  # # # # ##### #########   ###### ###    ## #    #  # ##   ##  ####  #   # #          #### #  #### ## ## ####  #
# # ####  ### ##     # #   ### ##      ### #  ###  ## ##### ## #   ## ####  # ## #  ## ### ## #########  # # ## ##  # ## ## # ##
# # ## # ##   ###### #   ###   #######   # # ##   ### # ##  ######  #  #### # ##   ##### # #   ## #  ###   # #  ### # ##       #
# # ## # #### # ##     #   ###  ## #####      ### # #   ###  ##    ## ## #  # #  #    ## # ###      ## # ### ##  ## #  # #######
# # #     ##    ###### #####   ##     ###### ##     ## ##   #### # ## #  ## # # ######## #  #  # ####     ##  # ##  ## #   ## ##
# # ### #  ####  ##     #  ### ## ## ##   #   # ### ##  ## ## ####  # # ### # #   #  # # ##   ##### # #####  ##  ##  #   ###   #
# #   ####  # ##  #### ## ###   # #  #### ## #### # ## ##  ## # ### # # # #     ### ## # #  ### # #     ### ####  ##   #   ## ##
#   #### # ## #  ##  # #    ## #####  ### ##  ##  # ##  ## #  # # # # #     #####          ####     #####    # ##    # ######  #
### ## #   #  ##  ## # # ####   ## # ##      #### #    ##  # ## #     ## ##  ## # ### # # ### ## ####  #####    ## ###### #   ##
#    # ### # ##  ##       # ## ##     ##### ## #  ####  ## # ## ##### ##  ####    # # ##### # ## # ## ##  #  ####  ###      #  #
#### #  ## # ###  ## # #### ## ###### #     ##   ## #  ##    ## ##     # ### ## ### #### ## #  #       ## ## ##   ## #### # # ##
#    # ### # # # ##### # #  ##  ###   #####  ### ## ## #####  # #  ### #   # ## ##   ##       ## #######      ### ## ##   ######
#### # # #        # #  # # ##  ## ###  ## ##   #  # #   ## ##   ####     ### ##    ##### ######   #    # ### ## # ##    #      #
#    # # ########   ## #    ## ## ##  ### #### ## # ###    ## ### ##### ##   ## ####     #  ### # # ########  # #    # ## ######
####     ##   ##### #    ####   # #  ##        #  #  ##### ## ##  # # # ## ###     # ## ## ## # ### # # ## ##     #######  # # #
#### ### ### ##  ## #### ## ### # ## ### # # # ## # ##     ##  ##        #     ### # ####        ## # #  # #  # #    ## ####   #
#    #    ##  ##    # #     ##     # # ####### #     #####  ##  ####### ## ##### ### # ## #########     ##   ##### ###   # ## ##
######## ##  ######     #####  ### # #  # # #    # ####### ##  ###  ##     # #    ## # #   #  # ##  ### ####  ## ### # ### ##  #
### #     ##  #   # ###  ## ####   # # ## # # ## ### #      ## # ## #  #####   # ##      ### ##    ## ### ### #  ##  # # #    ##
#   ##### ### ### ####  ##   ##### # #  # # ###   ## ######  #      # ### #  # #    ######   #  ##     ##  ##   ##  ## #   #####
### # #    ## ##  ## ##  ### # ##  # ##   # #### ##  ###  ##   ## #     # # ##### ###      ### #### ###### ## #####      #   # #
#   # #### ## ## ##   ## # #   ### # ## ### #  #  ## # ## ## #  ##### ###      #### ## #####    # ###  ##  #  # # # ####### ## #
### # ## # ## #   ## ##  # ###   # # ##  ## ## ##  # # #   ####### #    ## ##### ## #   #  ## ###  ## #### # ##         #####  #
### # ## #    ## ##   ## #   ###   # ## ### ## #  ## # ## ##  # #    ####  # ##  ## # ### ##  # ## #   # # #    ## # ##  # #  ##
#     ## ####       ####   #   ### # #   #  ## ##      ##  ## # ## # ## ##    # ### #  #   ##    # # ### #   # ##  ##### #   ###
## ## ## #  ##### #  # ### ## ##     ### # ###  # ########  #    ###  # ## ## #  #    ## ###  # ## #  ##   ###  ##  #  #### ## #
####     # ## ### ##     # #  ### ####   # # ## # ######### ### #####       ### ## #####     ####    ##  #   ###### # ###   ## #
######## #    # ##### #######     # #### # #  #        ## #  ## ##    ##### ##  ## # ##  ######## ######## #### # ###   ### ## #
## ## ## ####    ## #     # ##### # # ## # ## ### # ####  ## #   #### ### #### ##  #  ##     ## #    # ###         ## ###      #
#  #  #  ## ####    # ##### #            #  # # # ###  # ##  ## ## ## # #  ##   ## # ##  #####    ####   # #########   ## #### #
## ## # ##   ##  ##   #  ## #### # #####   ##      ### # #  ###           ### ###  # ## #####  ####  ###      # ## ### #    ####
#  ##    ## #########   ##    ###### # ###  ## ##### # #   ## ###### #######  ##  ##        ##   #  ## ### ####  # ##  # #### ##
##  ### ##     ## # ## ##### ## ##   # #   ##  ## ## # ###  # ##  #        ##  ## ## ##### ### ### ##   ## # ## ##  ##    ###  #
#  ##   #  #####    ## # ##  ##  ###   ### ## ##   # # #   ## ###   ########  ##  #     ####   ### #### ##       ## #### ## # ##
##  ### ## ##  #### ##    ##  ## ##### ##  ##  ## ## # ## ##  # ## ##    ####  ## # ##### ####      ##   ### ### ##  ##        #
#  ##       ##  #   ### ##### ## #  #   ##  ##  #  # # #   ##   ## #### ##  ##  #      ##  ##  ## #  ## ## # # ###  ##  # # ####
# ##  # ###  ## ## ## # # ##   # ## # # ## #### # ## # ### #  ####  ###  ## ###   # ##  ##    ######### ## # #  ### #  ####### #
# ####### # ##   # ##     #### # #  ### #  ## # # ## # ###   ##  # ##   ##   ## ####### #  ####  # ###  ## #   ## # # #####  # #
#   ## #  #  # #   #  ##### #    ## ##    ##  # # ##   # # # ###   #### ## ###     # #### ### ##     ## ## # ###  #   # # ## # #
### #  ##   ###### ## # ##  #### ## #####  ## # #  ## ## ###  ####  ##  ## ##  ## ##  ##    #    ###### #    ### ## ###   ##   #
###   ##### # #    #  #  ## # ## #  #     ##      ##  ## ##  ##  ##  ## ## #  #######  # #### ##### ##  # ####      # ### ## ###
# ### ##    # ####   ## ##  # #  ## #####  # ####    ##   ##  # ##  ### ## ## #   # ##    # #   # #  ## #  ### ## ### #    # ###
#  #  ##### # ## ### ##  ## # # ##   ## ## ####### ###### ## ## ###  #  ## ##   ### #  ####   #     ###   ## #  # ##  # ####   #
##   ##     # ## ##   # ###      ## ##   #  ##  #    ## # ##    # # ## ##  #  # # # ##   ## ##### ### ## ##    ######      # ###
#### #### #         ###   ##### ##   ### ## ### ## ###    ### ### # #   ##   #### # #  #       ####       ## ### #  ## # #     #
#     ############# ##  ### #    ###  ## #  #   #    ## #  #  ###     # ## ### #  # # #### ###    #### # ### # # ## ## ### #####
# # #   #####  ##    # ## # #### ### ### ## ###   ######## ##   #### ##### ### ##        ########## ####                ###### #
###### ## # # ###### # ## #  ###     # # #  ##  ###  # #   #  ### ##  ## # # # #  # # #####  ### ## # #  # # # #### # #    #   #
#           # ## # # # ## # ## ##### # # ##  ## # ## # ### # ##   ## ##          ###### # ##      # #   ## # #  ##  # # ## # ###
###### #### #  # # # # ## # #             ## #  # ##   # # # ## ####  #### # # ### # ##    # ### ##   ###  # # #### ########   #
# # #####     ## #        # ######## #### ## ## # ## ### # #  # ##   ## #  # ##### # ## #### # ###  # #### ######## ## #  #  ###
#     # ##### ## ##### #### ###      #  #  # #    ## ##  # ##    ### #    ##  ## # #  # #       #  #### ##### # ##     ##   ## #
### #            ## #   ##    ######### ## # ## ###  ### # #### ##   # ##  ####      ##   ####### #####   # #   #### ###  #### #
####### ######## ## ## #### ### # ##              # ## # #   ##  ###    ##  ##### ####  #  #### # # # # ###   ### #### ## # #  #
#  #  # #    ### ## ##  ##  ##  # ### ### # ## ## #    # ###    ##   ###### # # #  # # #####            #   ###     ## #    ## #
## ## ###### # #  # ### ## ##  ##  #### ###### #### ####  ## ##  ###      ###   # ##     # # ## ######### ### # ###### # ## #  #
#     ##   # # ## # #    # #  ####  ##  ## # #  ##    ## ##   ## ### ####  ### ##    # #      #### ## # # ##      ## #   ##### #
##### ####        # ####   ##  ##  #### #  # # #### # #   ## #####   #  ## # #    ####### ######   #    #  # ######  ## ## # # #
# #     #  #### #    #### ##  #### # ## ##   # #### ##### ##  # #### # #####   # #### # #### # # ### #### ##      ##  # #  # # #
# ##### #####   ####      ###   ##      ####    ##   ## # ## ##  ##     # #  # #         #   # #  ## # ## #  ####### ##   ##   #
# ## ## ##  #####    #### # ## ########    ####  ## ##       ## ##### ###   ##### ### # ## ###   ##     #   ## # ##  ## ###  ###
# ##     ## ## #  # ###      # ##   # #### #    ##   ## # ####  ## ##     ####  ####### ##   # #### ##### ###  # ### ## ##  ####
#  #####         ####   ####   #### #   ## ####  ## ##### ###  ##   ## ##### ## ###   ###### #  # # #   # # ## # # #  #  ## ## #
# ## ########## ########## ###   ## # #    #    ##  # ##    ##  ###      ##   # # # #### ##    ##     ### # ## # # # ## ###    #
#               # # #        # ###  ###### ### ### ## #  ###### # # # ##  ## ## #         ####    # ####  #    # # # ##   # ####
######## ## # # #   ##### ##   # # ####    #     # #  # ###  ## # # ##### #   # # ###### ## #  ####### # ## #### #      ### # ##
#    #####  # #####        ###        ####   # ### # ##     ##  #    # ##### ##        #### # ## ####  # #   # #   # ##        #
####    #######   ################ ##### ##### ###    # ## ####   ##   # ###    # ## ####   # #   # ##   ## ## # ### ## # # # ##
## ####    #  ###      # # # ###   ## #    ##    ## ### ####  ### ######  #  ########## ###   # ### ### ##        ##############
#   ###### # ## ###### # #     ### #  #### #  # ##  ##  # ## ##     # ## ## #### #####  # # ###   # #      # ## #  ##          #
# # # #            #       ###     ## ##   ## # ## ##  ##  #  ### ### #           ## ##     # # ### # ########### ##  ## # #####
###   #### ####### ###### ## ##### ##  ###  ### #   # ### ## ##         #### #######  #### ## # # # #  ## # ##  ###  #######   #
### ### ####           ##### ##     ## ### ###    ### # #  #  ## ######   ##  #  # ##  ##             ##       ###  ##### ## # #
#   # #  ### # #######   # # ## ### ##      #  # ## # # ##   ###    #### ### ## ## ## ##  # # # ## ###### ###### ## # ##     ###
### # # ## ##### ####### # # #####  ####### #### ## # # ## ####  #### #### ###  #  ## ## ############# #   # # #         # #  ##
# # # # #   # #            # # # ##     ##   ##  ## #      #  ##   ## # ## #### # ##       # # ## #      # #   # ####### ####  #
# # # # ###   ## # #######     #  #### #####  ## ## # #### # ##  #       # # ## #    # # #          #### #   #         # ## ## #
#     # # ### #######   ### ##   ###   ## #  ##  ## #   #### ## #### ###          #### # # ## ### #    # ## ## # #########  ####
### #          ###    #     ####   ### ## ##  # ##    ### ## ## # ## ######## ## ####### #  ##### # # ## ####  #   #### ### # ##
#   ## # # # #   ####### #### #### #   #  ###   #  ####    # #     #    ####  ##       # #####  ### # ##    ## # #             #
## ### # # # ## ## # # ####    # # ### # ## ### ##    ## ### # # #### #    ##  # # # ### ## #  ###### ## ####  # ## # # # ## # #
#    #########   #        ####            # ### ### ####       #####  ## ##### # # #   #      ##  ######    # ## ## # # #  # # #
# ##### # # #### ##### ##  ### # ########       # # ## # ########  ##  #   # ### ### #### # #### ##    # ####### ## # # # ######
# #       #            ###     ####   #### #### #    # #  #       ### ## #     #  ##  ##  #  # # ## # ###### # #### # ###  ## ##
#########   # # # ## ### ## ## #  ###      ##     ##     ## #####   #  ####### ## ###  #####      # ### ##        # #   ##     #
#   ### ### ##########      #  ## # #### # ### ## ######     ######### ##########   # ## # ## # #          ## ## ## ## ##  # # #
# #         #       #  # ## ####         ###   ####      # #      ###### #      # # #  # # #### # ## #######  ########  ## # ###
################# #   ## ######  # # # # ##  # #    ## # ### ###### # #    # # ## # ##      ##  ###   #######  ## ## # ##  #   #
###       ### ####### #### ## ## ### # ###  ## # # ##  #   ####   #     ## ###### # #  # ##  ##   ## ##     ##       # ### # ###
# ##### #        # ## # #        ##  # #   ##  ###  ## # #      ### # # ##    # ###### #  ###### ##     ###  ### # # #  ## #   #
# ### # # # # ##      #   ### # #### ##### ###   # ##### # ### ## # #####  ####      # ##   ##    # # ############ # ##  # # ###
#       # # #  ## # # # # #   # ##    ##   #   # # #     #   #          ##      # # ## ## #  ## # # #            # # #  ## #   #
############################################################################################################################## #
