# ##############################################################################################################################
# ### # # # # #  ## ##  # ##  # # #    # # ## ##   ##  ### #  #   ##  #   ## #  # #  ##   # #   ##   ##  # # #   #   ## # ## # #
#  #        # ## #   ##   ### #   ####   # #  ####  ##  #  ## ###  ##   ###  ## # ##  # # # ## ##### ### # # ## ## ###  #  # # #
## ##### ## # #  ## ##  #     ## ## #### # ## # ## ##  ## ##   #  ### ### ## ##   ## #### # #  # ##   ## # # #     # ## # ## # #
#    ### #    ##  #  ###### #    ## # #    ##      ###  #  ### # ##   ### ##  # #  #  ##  #   ## ## #  # # #   # #   ## # #    #
### ## ##### #### # ##      #### #  # #### #######  ## ## ##      ### # #  ## #### # #### ### ##  ### ## # # ####### ##   ### ##
#       # #          #### # #      ## #  # # ###### ##     ###### # #     ##   ##     #       ## ###  ## # # ## # ####### #    #
# ### ###   # #### ### ########### #  ##   # #       # #####        # ####### #### ## ####### ##  #  ### #    #     ##  # ### ##
###   # ### # #      # # ##  #     # #####   ## ####       ########    #   ##  # #### ## #  #  ## # ##     #### ####### #  ##  #
##### #  ######## ## # #  ## # # #   # ### ####### ## ######    #### #   # #  ##  # # #  ## # ##    #### # ##      # ## ## ## ##
# #     ## # ## #### # # ##  ##### #   # #  #### # ## # #  ### ## ## ######## ###   # ## #  #  ## #  ### #  # ###### ## ##    ##
# ##### ##   ## ##       ## ### ######   ##  ##  # #    # ##   #  #   ##  ##   #### #    ##   ##  # ## #### #  # ##  ## #####  #
# #  #   ### ## #### ## ##    #  ## ### ##  ####     ## # #### ##   #  ##    #  ##  #### ## ###  ## ## ## # # ##  ## ##   ##  ##
# ##   #     ##       ##### # # ##      ### #  #### ##### #  #  ##### ##  #####  ##          ### ## ## #  #    ## ##  ## ####  #
# ### ###### #### ## ### ## ### #  ## # #   ##  ##   # ## ## # ## ##   ## #     #### ####### # #  ###  ##   ####  ### ##  # # ##
# # ### #    #  #### ##   #  #  # ##### ## ### #### ## ## #    ## #  #  # #####  # #####   # # ##  #  #### ##  ##  ##  # ## #  #
#   ##  # ## # ##     ###   ## #####            # #  # #    # ##    ##### #  #  ## ##  ###     ###   ## #  ## ##  ####    # # ##
## #### ###  # ##### ##   ###   ## ## ######### # # ## #### #### ## # # #### ## ##  ##  ###### # # #### ## #   ## ##   ####    #
#  # ##  #  ##  ##   #### ##  ###   #######       #  # ## #  # ####      # # ##  # ##  ## ##          # ## ## ##   ###  ##  ####
##    ## ##    ##### #  #  ##  ## #  #      ##### # ## ## ##    ##  ###### # ###   #  ###  # ## ## #### #   # ####   # ### ### #
#  # ##  ## ## #  ## ## ##  ##  #### ## ##### ###    # #   ### ### ## ## # # # ###   ## ## ####### #  # ### #  # # ###   # # # #
## ###  ##  #### ##  #  #  ####  ##  #### ##    #### # # ### # # # #   # # # # # ### #  ##  # ## #   ## # # # ##    ## ### #   #
#  ####  ##  ##   ## ## # ## ###    ## #   ## #  #       ##      # # ### #   # # ##    #### # ##   ###  #   #  # ####   ## ## ##
## # #  ##  #### ##  ## #  # #   ####  ## ###### #### ###### ## ##    ## ###   # ##### # #    #### #### ## ## ## ## ## ##  ## ##
#  # ## #  ## ##  ## #  ## # ### ## ##     # #    ##  #  # #### ## ####  # ###    ## #   #### # ##   ## ## ##    #  ##  ##     #
##   ##   ##   ##      ##  # ##   #  ##### # #### ## ## ## ## #  # # ### #  #### ##  ## ##       # #### ## #  #### ### ### #####
####    #    ####### #  ##    ### # ## #   # # #     ##  # #  ## # #  ## # ## #  #  ###  ##### #   ###  ## ## # ##   # #    #  #
#    ##### ##### # ### ###### ##  #  # ## ## #   ### ## ##   ##    # ##  # ## ## ## ##  ##   #### ##   ##  #  #  # ### ####   ##
#########   ## #    #  ## ##  ###   ## #  #  # #  ####   ### ### ###  ## #  # ##       #### ##  #  ###  ## ##   ##  #  #  ###  #
###     ## ##  ## #   ### #  ## ###  # ## ##   #### #  ###    #      ### ## #  ##### ### ##  ## ## # ## ## #  # ## ## ## ##   ##
#   ###  # ## #######       ### # ##   ## #  ###  # ## # ####   ###### # ## ## #  #   #  ## ##   #   ## #  # ####  ## #  ## # ##
##### ## #  # ## # ### #### # #    ## ##  ## # ## # #    ## # ###  ### # ## ## ## ###   ##   ### ## ##  ##   # ###  # # #####  #
# #   ## # ## #    # #### # # #### ## ## ##    ##     ####    ##  ## # # #  ## ## # ## ##  ### # ##  # #### ##     ##   # ##  ##
# ###         ####             ##     #     ######## ##  ####  ##  # # # # ###  # #     ## ##     # ## # #     ###  ###   ###  #
# # ### ### ### ######### ### ####### ## ####  # # #  ##  # ##  ##   # # # ##  ## ## ##### ######   ##     ## ####### ## ## ## #
# # ##  #    ## #  ### #####  # # #         ## # # ## ### # ## #### ## #   ## ##     ##    #  #### #### # ###### ##    # ##  # #
#    ##### #### # ##   # # ## # # ### ## ####  # # #   ##       # #    ### #  #### #######   ## ## ## # #### # # ## ##    ## # #
### ####   ##   #  ### # # #       ##### ## ##     # ######## ### ### ## # ## # ## #  ## ## ###  #  #   ## # # # ###### ###  # #
#    # ###  ### # ## # # # ###### ## #   ## ###### # ###  ##  # # ##  ## # ## #  #   ##   # # ## ## ## ###     #  ##    # # ## #
####    ## ###  # #    #   # # ## #  ### #   ####  # # ## #  ##    ## ## # ## ## # ###### # # #  #  ## # # ##### ###### # # ## #
# #####    # ##   #### ### # # ## # ##     ###  ## # # #    ##### ##  #       ##    # ##  # # ## ##          ###   ###  # # #  #
#   ###### # #  #              #     #### ## # ##  #   ####   # #  ## #######    # ##  ##      #  #### # ##### ## ## ##   # # ##
###    #   # ###### ## # # # # ## ####    ##    ## ## ##  ## ##   ##  # #   ## #####  ###### # # ##  # #  ##    # #  #### #    #
###### ### #  ## ####  ####### #    #####  #### #     ## ##   # #  ## # ### ## # ##  ## ## ### # ## #### #### ###   ## #    ####
# # #        ##  # #  ####     ####  # ## ##  # ##### ##  ## #####    # # #  # #  ##     # ### #  # # #  # #      ###  #### ## #
#     ## ###  ## # ####  ##### ##### #     ##   #  ##  ## ##  ##   ##     ## # # ##  # # # # # # ##   ## #   ####   ## ## #  # #
##########   ##  #  ##  ##     #   # # # ###### ##    ##  ###  ######## #      # ### ##### #      ## ##    #    ###### ## ## # #
## #### #### ### ##    ####### ###   ###  ##    #####  ##  ## ## ##  ##### ###    ##   ##  # ## ###  ### #### ######    # ## # #
#  #     ##       ## #   # #   # ## ###  ##### ##  ### #  ##   # #  ## # ##### ####  ###  ####  ##  ##    # ###    ####        #
## #### #########  ##### # # #      ##  ## ##  ###  ## ##  ## ## ##  # # #        ##   ##  ##  #### #  ####   ## #### #### #####
#  ###    ##    ## ## #  # ##### ## ### ## ## ## ##     # ##  ## ## ## # ###### ######  # ##  ##### # ## ## ###   ##  ##   ## ##
# ## ## ####### #  #  ## # ##    #       #        ## ##    # ##  #  ## # # ##   # # ## ##  ## ####  # #   #   ## ####  ###     #
#  #    # ### # ## # ### #  ####### ## # ### ### ####### #   ###   ##    #  ## ## # #   ## #   ##  ##   ### ###  # ## ##   ### #
## ####    #    ## #  #  ## ## ## ###  #      ##  # # ######     #### #### ##     #   ###  ## #### ## # # # # ##   ## ####  ####
#  # ##### #### #  ## # ### #     #   ### ## ###### #   # ###### ## #   ## #### # # #   ## #   ##  ## ### # # #  #     # # ## ##
##   # #   ##   # ##    ##  #####   ###   #   ##  # ###           # # #### # #### ### #### ###  ## ##  #        ###### # #     #
####   ### #### #  ####  ## ##  ### ##### # #  ## # ##  ##### # #      ##     ##   #   ##    # ##     ## ## ##### # #### # #####
# #### #    ##    ## #  ##   # ######  #### ## #    ### #     # ## ## ##  ## ##### ###  ### ## #  # ###   ##### # #  ##  # ##  #
#      ## ##### #    # ##### # #  ####      #  # #### #### ######  #  ## ###  ## #     ## #  # # ########  ## # # # #### #    ##
###### ## #  ##### #    ##     # ##    ### ### # ##    ####### ###### ## # ####  ##### #  # ## # # ## # ##  # # # # # #  # #####
# ## # ## # ##   #### #  ## ##   ###########      ####  # #  #   ###        # ##  ##   ## # ##     ##   #  ## # # #   ##     # #
#      ## # #  # #  ### ####### ## # ###     # # ##  ##   ## ### #   # # #### ###  ###         ######## # ##  #     #### ##### #
#### #  # #   #####  #    ## #   # # # ##### ###  ## #  #### #   ##### #   ## # ## # ## #### #     ## # #  ## # ###  ##    ##  #
## ####   ## ## # ## ### ### ###   #    ## ###### ## ##  ##  ### ## ##### ##  # #    ##### # #######  # # ##  #   ##### ##  ## #
#   ##  #  # ## # #          ##### #### #   ##     # ### #  ## # ##  ## # ### # ####  ##     ###   ## #    ##   #####    ##### #
# #    ### # ##     # ###### # #   # ## # # ###### # # # # ##     # ##     #  # ## # ####### # # # ## ####  # #     ## ###     #
###### #   #  ##### # #    #   ###   #  ### #  #           #### ### ##### ## ## #     # #      # #### # ### # ## #####   ##### #
#      ### # ## # ######## ### ##### ##  #  ## ## # ## ### # #  ##  #      #  # ### ### #### ### ##     # #    ####    # #     #
########     ##   ###   #   ## #  #   ## ## #  ##########      #### #### # ## # ##   ##  ##       #####   # ##  # #### ####### #
#      #####  # ### ### ### ## ## ###  # ## ##  ## ## #   ####  ##  ## ### ##    # ###  ##  ### ### # ### # ###   # ##  # # #  #
##### ## #### # ##   #  ##  #   # # ##       ## ## #  # # #    ##  ### ##   #### # ####  ##   #  ##    #     ## # #  # ## # # ##
# ##  #  #       ### ## ### # # # #  ## ## # ##  #   ####### #    ##   ## #####    #  ##    ##########   # #  ######   ## # # ##
# ### ## ##### #            ### # ## ####### ### ###  ##   ### #######  # # # #### # ###### #  ###   ## #####   ## ## ##       #
#              # # # # ## #        # # #  #    #  ###  ###  #   # ## ## #   # # ##   # # #  ##   ## ##    # ## ##  #     #######
##### # # ## # # ### ###  # # #### # # ## ####   ## # ## ## ###   #  ## ## ## #    ###   # ##  ###   # #### ###### ### ###  # ##
#     ######## ################            ##### ## #  # #   ####   ###    #  ### ## ###   #  ## ### #  # #    ##      # ## #  #
## ## #        ##      # # # ##### # ## ##        # ## # # #  # ## ## #### # ## # ##   # #   ### # # # ## # ##########   ##   ##
####### ## ########### # # # # #   #  #  ### #### # ## # ####   #   # # ## # ## #  # #######   # #   #  #    #   ##  ## ### #  #
#   ######## ## ###      # #   ### # ######### #           #### ## ##   ## # ##   ## # ## #  ### ### # ## #### ###  ###     # ##
### # ###       # ###### # ### ##  ### # #  #    # # ### ###  #  #  ## ##  #  ### ## # ##   ##       # #   ##  # ## ##  ########
#     # ####### # ## # #   # #  ##  ## # ##   ## # ##### # ## ## # ##     ## ##   ## # ### #########   # #####   ##  ##  # # # #
##### # ## ##   # #      #   # ######     # # #######               #### ###  # #  # #  #  # ##    ###   # ##  # ## ### ## # # #
#     # #  ####   #### # ###   ## # ##### #####  ## ## # ######## ###      # #####   # ## ##  ####     ###  #### ## # #      # #
## ##     ##  ###  ##  ####  #  #   ## ## ##    ##   #########      ##### ## ##  ### # ##  ##   ######  ## ## #  ## # # ####   #
######### ### # ## ## ##  #####   #    #  #### ##  #  # #      ## #####       ## ##     ##  ## ##  ##  ##   # ## ##      ##### #
# ##       #    #  #   ##       #### #   ##    ## ###   # # ## #   ## #### ## #   #### ####  #  # #### ### ## #     ####     ###
#  #### ## #### ## ######## # ######## #  #### ##   ### ##########  # #     #### ##  # # #  ## ## # #   ##  #   # #   ## # #####
## ##   #  ## #  # ###    # # #   # #####  ##  ########  # # ## ###   #####  # #  ##   # ## ## ##   # ##### # ### # #  # #     #
#  #######    ## # # #### ####### #    ### ###  ## ## ## #   #   ### ###    ## # #####    # ##  ### # #  #      ######## # #####
## # # # #### ##     # ## ## # ## ## ###       ##  #  ## ###   #     # ## #       ##   ##   ## ##   # ##   ## #### # ####### # #
#              ##### # #  ## # #     # #######  ## ##      ###### ##   ## ##### #  ###### ####  ### # ## # ##        # ## #    #
###### # #####  ##   # # ##  # ##### # # ### # ##  #######  # # ######  # ### # #### ##    ##  ## #      ###  # ###### ## # ####
# ########   # ### #      ## # # #     # # # # ###  ### ### # # ##     #### #    ##   ####  # ###   # ##   ########  # ##      #
# #  ## #  #     ### # # ##      ##### # # #    #  ## # # # #   ###### # #    ####### ## ##   # ### ######## # #  ## # ## ######
# ## #  ####### ######## ## # ##       # # #### ##          # ###        #### ## ##    # #  ### # #   #   #  #   ### # ## # #  #
# #  ##  ##      # ## #   # ##########     ##    ########## # # ######## ##    # ##### # # ####     ### ### ## ####  # ## # # ##
# # ####  ###### # #  ## ##### ## ######## ### #  ##  ##    # # # # # #   #### #  ## # #      ## #### # # # #     ##   ##      #
# # #  ## # #    # ## ## # # # #  #    #    ##### ###  ####   # # # #   ###      ##      ### ##  #  # #     # #####  # ## ######
# # ## ## # #### # #   # # # # ## # ## ## ### #    #  ##  ### #       #  ##### #########   ##### # ## # ##### # # # ####      ##
#      #  #  ##    ### # # # # #  ###     # # #### ## ###     ### # #### # #      ## #   ####  #      #   # #       # #  ## #  #
# #### ## ##    ##  #        # ## #######   # # #   # # ##### # ######     ## # ###  # #  ##  ## ###### ### # ####### # ###### #
# #          ######   ######        ##  ### # # ### #   ###   # ## # #### ##### # ## #### ### ## # ## #  ##        ## #      ###
# ### # # # #### ### #####   #### #####             ###   # #        ## # # ##    ##  ##   ##  # # #  # ###### #####    ### ####
####### ### #        #     ###    # # ###### ###### #### ##### #####         ### #### ####  ##   # # ## # ## # ### ## ### ###  #
#   ####### # ## ##### # ###### #     # #### ##            ##  ##    # # # #      ##    ## ##  # # #      ## # #           ## ##
###   ### #########    #####    # # #         ####### # ##    ###### # ###### ## ###### #  #  #### # ####### # # ##### # ###   #
# ###     ###   # ######     ## # ######## # ##       # ## ##  ##    # #  ##  ## ## # # ## # ## ##     ####    #     # #     ###
#     ### # ###    ######### ## ###        #  #### # ##### ## #### # ####    ##  #    # ##   ##  # #####  ####   # ### ## ##   #
## # ####     ####            # ####### # #######  # #     ## # ######  ######## #### # ## ###  ##   ### ## #  ############  # #
####### ##### ##### # ## ## ##### # ##  # ##      ##### ##  ### # #  ## ### # #       # #      ### ###        ###     #   ######
#                   ###  #######     ########### ##     #  #### #   ##        ####### # # ###### #     # # ##     # #   ##### ##
### ######## # ####  ##### ## #  ### # # # # #   ## ## #####    ###  # # ####   ##                 # ### ###  ######### ###    #
#   ##   #   # ##   ##        #####            #  # ########### #   #######   #  ###### # # #### # #  ##   ##        ##     ## #
#####  #   # # ### ### ## # #  ## ### # ## ### ## ### # #       ### # ##    # ##        ###  ####### ##  # #  ########  # # ## #
###### ### # ### #   ###  # ##        #  ###   ## #       ##### # #    ## ########## ##  ## ##     ##########     ## ###########
#      ##  ####    ###   ####  # ## # ##  ## # #### # # # #         ######## ##       ##  #    ## ####    # # ###        # ## ##
#### #  ####    # ##   ### #  ## #  # #  ##  #  ######### ##### # #  # # #   ####### ##  ## # ##       #### # ##########    #  #
#    # ##    # ## #### ##    ##### ## ## #  ##### ## ######   ###### # # ### #   ####### ## #  ## # ##### # #    ##    ## #   ##
## ### ## # ## #   #####  ## ## ## #   ####  ##    #  # #####            # # ###         ## ###########     # ##  # ############
#  #    ###### ##### #### ## #     ## ##    ###### ##   # #### # ### ### #       # ## ## ##             ## ######      # ####  #
###### ##      #####   #  ###### # #   ## # ##        #   # ######   ##    # # # # #  #  #  # #### ## # ##   # ## ####    # # ##
#       ## # # #     #   ##      # ## ##  # ## # # # ## #          # #  # ## # # # ## ## # ##    # ## # #  #   ##    ## #      #
############################################################################################################################## #
