# #############################################################################################################
#     # # ##  ## # # #    #  ## #    # ##   # ## #   ## # # #    ## ##   ## # ## # # ##  # # #   ## # ### ##  #
##### # #  # ##  #   #### # ##  ####    # ### ## # ###      # ##### ## ###  # ##      # ## #   ###     #  ### #
# ### # # ## ###   # #       ## #  ## ###     ## # # # ###### # # # ##   ## # ## ###### #    #  ##### ## ##   #
# # # # # ##  ## ###### # ##### # ##  # # ### #  #        ###   # # #  ###  # ##    #     # #####           # #
# # #      # ##  ## # ### ## #     ## # #   #### # ########   ###   # ## ## #    #### ####### # ### ### # ### #
#   #### ###  # ##    ##  #  ## #####     #####  # #     #### # # ### ## ##   ####### ### ### #  ##  ####   ###
# ### #    ## #    ##### ## ##    ##  ##### # ## # # ##### ##   #  ## #  ## ###       # # #   # ##  ## ## #   #
# # # ## ###  # ######   ## ## ######  ###  # #  #     ##  ## ### ##  ## ##  #  ### ###     ### #  ##   ##### #
# # #  #   ## # ###  ### ## ##  ###   ##   ## ##   ###### ##  ##   ## #  ## ## ## ###   ######  ## ## #### ####
# # ##   # #  #     ##   ## ## ## ### ## ###  #  #####     ##  ## ##  ## ##  #      ### # #  # ##      # # # ##
#   ## ###### # ###  ###  # #  ## # #      ## # ## # # #####  ###  ##  #  ##   #######  # # ## #  # ## #      #
### #     ##  #  ##### ## # ## ## # # ######  #    # #  #  ## # ##  ##   ##  ###   ##  ##    #   ## #    # # ##
# # # ####### # ## ##   #   ## ##   #  # ##  ## # ## # ## ##    ## ##  #####   # ###  #### ### ###### ## # ####
# #   ## # #        ### ## ##  #### # ##  ## ## ###  #    #####     ## ##### ###   ##   ## #       ########## #
#   ###  # ## #######    # #  ## ## #  # ##         ## #### ##  ######   ##  # # ##### ##    # # ### ## ##  # #
###   # ## ##  # ## ####   ##  # #    ## ### ######### #  #  ## ## ##  #####     # # #  # ## ##### #  #  ## # #
#   ### #  ## ## #  # #  #  ## # # ##  #  ##  ###  ##    ## ##  #  ### # #   ##### # # ##  #######   ## ##    #
### # # # ##   # # ## ##### #    #  ## # ### ## ## ## #####  ## # ##   # ### ##           #### # ## ###  #### #
#   # #    ## ##   ##  ##   ## ### ##### ##   # #  ##   # # ##    ### ##   #    # ### ###### # # ##  #  ## #  #
###     ####   ### #  ##### ## # #  # #   ###     ### ###    ## #  ## #  ### ##########  # # # # ## ## ### ## #
# ### ###  # ####  # ###           ##   # ##  ######      ## #### ###   ##       ## ##  ## # # #  # #   #  ## #
#       ##    # ## # # #### ## ## ##### #####   ##   ## # #### #  # ## ##  ########  # ###   # # ##   ### ##  #
#### ###### #    #   # ## # #########    ## ## #### ####### #  # ## #   # ##  ###   ##   ###     ## ####  ## ##
# #  ## ##  # # ## # # #     ## ## #  ####  ##   ## ## # #  ## # ## # #    ##   # #### ### # #####     ## #   #
# ##    ## ####### ### ## ##### ##   ### # ##  ###  #  # # ###   ## # # ##### ### ##    ##   # # ## ##### # ###
# #  ## #   ## ##   ##    ####  ## ### # #  ## # ## ## # #   ###  #   #  ## #  ##  # ####  ### # ##       # # #
# ##  # ## ##   ###  ## ###  ##    # # # # ##     # ##     # ##  ## ####    ##  ##      ##  #  #    # ###     #
# ## ####   ###  ###      # ##### ##     #    ##### ## ######## ##   # ######## ## ######## ##   ########## ###
# ## # ## ###   ## ### ####  ##    # # ### #### ##   # # ## ##     ### ##   ##        # ##     #    ##    #  ##
# ##    # # ## ##  ##  ## ##  ## ### #####  ###  ## ##   ## ## ##### #  ## ##  # ######  ##### ####### ## ##  #
# #### ## # #   ##  ##  # ## ##  #    ##   ## # ##     # ## #  # #     ### ## ##   ## ##   ##  ######   ##### #
#   ##  #   # #####  ## #  # ### # ###### ### # ## ######## # ##   ######      #####   # ##### #      ####  # #
# #####   ###  #### ##  # ## #   # ## ##  # #   #   #  ###     # ###      # ##     ### #   # # # ######  ## ###
# # ##  #   ##  ##   ## # #  ## ##     ##   ## ## ### ##   ###     ## ### ###  ### ###   #           ###      #
#    # ## ##### #  #### # ## ## ## #####  #### #  #   ## ### ## # ##  # ############ # ##### # ### #  #  ## ###
# ######   ## # ##  ##    ##  # #   ## ##        ## ###   ## ####### ##  #  #  # ##        # #   ###### #######
# ## ##  ###    ### ##### ### #   # #  ## #### #  # # ## ##    # # # #  ## ## ## ##### ####### #    #         #
# #   ## # ## ###    ## # # # # ##### ##    #### ## #  #    ####       ###  #       ## ## # ######### ####### #
# # #### # ## # ### ##  # # #   ## ## #### ## ##### # ## # ###   # # ### # ## #### ##   # #   # ## ## ##   ####
#   # #  # ## # # # ## ## # # ###  ##  ### #    ##       ###   ########  #       ###  ###   ###          ### ##
## ## ##      # #   ## ##         #### # # # ####  # # ###### ### ##    ## ## ##  ## ## # #   # ##### # ##    #
#   # #  #### # ###  # ### ######## #           ## #######     #   ### ### ########   #   # # # # ########### #
###   ##   ####   ##    ##       ## ### # ######## ## ## ##### # ###   # #  ##  # ###   #######       ## ## # #
#   ###  #  ### ###  ##### ########   ### ###  # # #   # # ###     # ### # ### ## ##  #      ## #### ##   #   #
### # ## #### #  ## ###  #   ## ##  ####    ## # # # ### # #   #####  ##     # ## ## ### ###      ##    #   ###
#   # #  #### # ##  # ## ## ###  ##    ### ##  # #    ##     #     # ### #####  # #  # ############### ########
# #   # ##      ### # ##  #   ## ## ####   ### # # ##### ###### # ##   #     # ## # ##  #  ##       ## # ## # #
#####    ######        ## # ###   #    ### #   # # #   #   ########  # # #####      ## ## ##  #### #####  # # #
## #####  ## ## ######### # # ## ## #### # # ### #   ### ### # # ### ### # # # ####     # #  #######  ### # # #
#   ## # ### #   ####   #      # ## # ## # # ###   # #     # # #  #   #  # #    #### #### # ##     ##  ##     #
###       #  ## ##  ### ## #####  # # ## #     ## #### ## ## # # ## ### ## ## ###  ####        #####  ##  ## ##
### ##### # ##   # ##   #    #   ## # ##   #####  # ##  ###    # ## ##      # # # ### ## ##### ### # ##  ##   #
# ### ### #  ## ##  ### # #### #### # #  ########    # ##   ##       ## ###       #          ### #      #### ##
#  #      ## #  #  ## # #  # # ###  # ## ###   ## #### #### ##### ####   ## ## ##   ### #######    ### ### ####
##   # ##    # ## ##  # # ##     ## #        ###    ##  ##      ####   #######  # #   ######  # ## ##### #    #
#  ### ##### #  #  ##     #  ## ##    # ###### # ##### #### #######  #       ####### ####  ##    ###  #  # ####
## ##  #       ## ##### ### ####### ######  ##     ##  #  #   # # # #### # # ## ## #### # ### #####  ## ## # ##
##############    ## #   #   # ## #  #   ## ## ###  ## # ## ###      ##########    ## #   # #     ##  #  # #  #
# ###          ####  ## ## ### ## # ## ###       #####          ## #      # # # ##### # ###   ###### ## ## # ##
#  #  ## ### #  # # ##   #   # ## # #    ### ####### # ########  # # ###### # #   # # # # ###    # # #        #
## ########### ## # ####   ### #  #   #####  #   # # # # ### ##### #     ## # # ### # # # # # ####   # #### # #
#  ### ### ##       # ## ### # # ## ### ##  ## ### #            ## ## # ### #         #            #    ##### #
## # # # # #  # ## ##    # # # # ##     ### ##   # # ######## ########### # # #######   # ## # ### ## #     ###
#            ## #     ##            #####   ## ### #       #### # #    ##           ## #######  ## #### # #   #
## # ### # ###  ### #  # # # ## # #   # ## ###       ## ## # #      ####  ## # ######    #   # ##     ###### ##
#  ####### #   ##   # #### #  ##### ###  # # # #############   ######  # ### #      ## #   ####### #####  #####
## #   ### ###  ## ##   ## ##   ##    ## # # #       # # ##  #  #   ## #   # # ## #### # #   #######     ##   #
#  ###     #   ##   ## ##   ## ######          ### ###   #  ###   #  #   ########  # # # # ### ## ## ###### ###
## ##  # # ### ### ##  ## # ##     ### ### ## ####     #   ## ## ###   #####  # ## # ####### #                #
###### # # #   # # ###  ### ## # #   ####  ## #  ## ######    #####  #     ## # ####   ## #    ## ## ### ######
# #    # # # # #     ## ##   # # # #    ## ##   ##     ######## # ##### ##      # ## ###  # ##  # #    #      #
# ### ## # # ##### ###   ## #### # # # ### #  ###### #    # ##        # ## ## #        ##    # #### # ## #### #
#     ## # ####      ## ### # ## # # # ##  ##      # # ##      ##### ## ##  ### ### ##    # ####### # #########
##### ## # ##   ## ###  ##     # # # # ###### # # ## # ## ####     #### ## ##     #  # ## ### # # ### # #     #
#     #  # ### ###   ##  ### ####### #  ##    # # ## # ############## #### #### # ## # ##          ##     #####
####### ## # ###   ########   #    # # ##  ## # ######                   #   ## # ## #  # # ### # #### # ## ###
#       ## #     #  # ###   #   # ## #  ## ## #  ## ## # # ### # ## # # ### ##  # ## # ####   # #   ## #      #
###### ##  # # # ##     ## ### ## #  ##  #### ##     # # #  ######  ### ##   ## # #  #  #### #### #### ## # ###
#       ######## #  ######   #### # ##  ##    ## ## ## ####     ###   ##### ##  # ## ## # #### ##    # #  #   #
## ## # ##       ##    ##  # #    #  # #### # #   # ##   ### # ## ###### ###### ######          ## # ### ## # #
##  ###  ## # ## ## # ##  #### ## # ##  # # # ## ## ####   # #    ## #    ##  #  ## ## #### ###########  ## ###
#  ###  ##  # #  #  #  ##   ####  # ###   # # ##  #    # ##########  # ####  ## ##        #  # ## ### ## ##   #
#### ## #  ## # ### ##  # #    ## #   ## ## # ## ########## # ## ## ## # #  ####### # # ###### #   #   # ## ###
#       # ##  #  ## ## #### # ##  # #  ########   ##  # #         #        ###  # ### #          #   # # ##   #
# ## # ## ### ####  #    ## #  # ## ##      #### ### ##   # #####   ########   ##     ## ########## ####### ###
#  ###  ###   #    ### #  # ## #  # #  # #### ##        # ######## ######### ########  # ## ##### ### #       #
# ##   ##   # ## #  ## # ##  # ## # ## #  ##     # # ## #       ##              ##    ##              # # # # #
############################################################################################################# #
