# #############################################################################################################
#  #    ##  #    # # # # # # #    # #    ##  # #    ## #  # #  #      ## # #  ## # # ## #  ## ##  # # # #  ## #
## ## #  ##   ## # # #   #     ##   ## ##### # ### ###   ##   ## ######      ###      # # ##   ## #       ##  #
#  ##### ## ######   ### # ##########  # # # # #   # ###  # #       ##  ######   ## #        ####   #####  ## #
##   #      ##  #### # # # ## ## #  ## #   # # ###   ##  ###### ####### ###    ###  ##########  ###  #######  #
#### ##### ### ##      # # ##  # # ### # ### #  ## #####  ## ##     # # # ## ### #####   ##    ##   ##   ##  ##
# #  # ##  ##   ### ##      ## #   # #    ## # ##    ##  ##  #  #####   #         ###  ###  ###### ##  #####  #
# ## #  ##  # ############ ##  # ###   ####  # #### #### #  ## ##   ## ## ######### ##   # ## # #   ## # ##  ##
# #    ##  ##  ## ## ###    ##    ## #### ##    # #  #     ##   ## ##       ###  #     ###  # # # ###     ##  #
# ####  ## ### ## ## #   ## #  ####   # #  #### # ##   ####### ##   ## ###### # ## ###   ## # # # ### #####  ##
#   ### #   #  ## #    ###    ##  ## ## # ####  # #### ## # #   ## ##  # # ##    # # ## ### #             ##  #
## ##   ## ## ##  ########## #### ##  # # #  ## #  ##   #   ### #   ## # # ### #     #####  # ### ########## ##
#   ###  # #  ## ##   ## ###   ##    ##     ##  # ### #   ### #   ###       ## # # #   # ## #  ##  ## # # #   #
### # ## #   ### #  ###      ###  ##### #####  ##   #### ## # # ### # ##### #  # ####### #    ####### # # # ###
#     ##   ### #   ######### # # ## ##   ## ##    ####   ## # # #        #### ####### ## # ##### # #    # # # #
##### ### ##   ## ### ###      # #  ####  # ## ##### ## ##  #     # # #### #    ## #   # #  #  # #   ## #   # #
#  #   ## #  ###  ##  # ##### ## # ## #  ## ##   # # ## ## ## ## ## #  ### ## #### # ### # ## ##   ######## # #
## ## ##  ##   ##  ## # #  #  ##   ## ##  # ## ### # ## #      #### #### # #   ##      #       ## ##  ## #  # #
## #  ###    ###  ##    ## ##  ## ##   ## # #   ## # ##   # # ### #### # #   ###### #### # ## ###  ##  # ## # #
#    ## ####  ### ## ####  ## ###  ## ##      # ## # #  #######    ##  # # ### ##    #   # #### # #### #      #
#### ## # #  ##       # ## #  # # ##   ## ##### ##     ### ##### ##### #        ####   ##### ## # #  # ### ####
#    #  # ##  ##### ### #  ## # #  ###        ######## #    # #  # ##  # ### # ## ## #### ##  # # # ##  ##   ##
####   ## #  ##      ## ##  #   ##   #### ###### ##    # ####   ##  ## # # #####  #          ## #    ##    #  #
#  ### ## # ####### ##   ## # ##### ##     # ##   ####     ## ###  ##        #### # ##########  # ##### #######
## ###        ###    ### ## # # # #  #####    ## ## #  # #### #### ### #### ## ##    # #     ## # # ##      ###
## # # ##### ## ### ## #      # #   ## ##  ####  ## # ######  # ## # #  # ###  #  ####   ## ##      #  ## #   #
#    ### # # ## ##  ## ###### # ###  # ### #  # ##     ##  ## #        ##   ##   ##    #  ###### #### ### # # #
### ##   # # ##  ## ##  ##    # ##  ##  ## # ##  ## # ### ##    ######### ###### ## ##### ## ##         ### ###
### ####      # ##  ###  #### #  ##    ##     # ### ###    # #######       # ##        ##### ## ###############
#    # ###### #  ##  ### # #  # #### ######## # ##    ####    ###    #####   ### ####### ##  ##           ### #
### ## ##     ##  # ## # # ## #  # #   ## ### # ### ###  ## ###   ## #  ######   #        ## ## ########### # #
##   # ##### ####   ##   # #    ## # ###      #  ##   # ##    # ###### ## # ####   ### # ### ##      ## ###   #
#  ###  # ##   #### #### #   ####      ## ###   ### #   ## ##    ## ## ## #  ##  # # ### ##  #  ####### # ### #
# ##### # #  ### ##   #  ###   #### ########## ## # #####   ## #  # #   # # ##  ####  ##  ## ##   ## #     #  #
#  # #    ## ##   # #   ##   ### #   ### ## #   #    ## # ######### ### # # ## ## ###  ####  #  ###    ##### ##
# ## ## ###   ### #####  ### ##  ## ## # #  ## ## #####     # # # # # #           # ##  ##  ## #### # ## ##   #
#     # # ## ##    # #  ## # ## ##  ## # ##    ## # ##  #####   # # # # ######### # #  #### #   # # ####    # #
##### # # ##  ## ### ##       #  ##       ### ##  #    ## ### ### #      #     #### ## # ## # ###    #   ######
#   # # #  ## ## # # ## ## #### ### #### ##   ### # ## ##   # # # # ####   # #   ## ##    #       ##   #      #
### #   # ##   # # # ## #   ##  ##     #  # #  ##   ####  ### #        # # # #####     #### #### #### #### ####
# # ###    ###        # # #  ## #  ########## #### ## #  ###  ## ## # ###########  #######    #### ####  ###  #
#    #  # ## # #############    ## #  #  # #   ### ##   ## ##     #####     #   ## ## ## ## ### ## # ## ###  ##
#### # ## ##    #   ####  ### ###  # ## ## ###  #     # ##  # ###  # ## ##### # ##    ## #            # # ##  #
# ## ###  #  #### ### #  ## #  ###       # ####   #######  ##   ##          # #### ####    ##### ####        ##
#  # #### ##    # # # ##      ## ## ###### # ## ###    ## ### ######### #####  ##   ##  ##    ## #  ### # # ###
##     #   # ####   # #######  # #     ##  # ##   # #####        ###  #### ## ##  ###  #### #  ### ###  ###   #
###### ### #    # ###   # ##  ##   ###### ##  # ### ####  ######## # ### # ##  ## # # ### ########   ##  ######
# #  # # # # ####  ### ## ### ####  ### # #  ##        ##  #####           ## ##  #   # # ## ### # #####      #
# ## # #   #      ##   ##      ##  ## # #   ### #### ###  ##   ## ## ## ##### ## ## ###   ## #       # ########
# ## # ### # ######## ########  ##        ###   # #### ## ## #  # ######### # #         # ##   # # ### ##  ## #
# #  # #      ##  # #  ##  # ## ## ######## ###     #  ## #  ##    ## ##      # ############ #######   ## ##  #
# ##   ## # #  ## # ##  ##   ## ##       ##   # ##### ##  # #### #     #### # # ##### ## ##       ## ###   # ##
# ####    # ##### #  ##  # #  #  # # ## #####     # #  # ## # ###### ### ## ###        # ## ######## # # ###  #
#  # ### ##  ## # ## ## ##### ## # ###### # ## ##     ## #       ######  #   ## ######## #    ## ##    #     ##
##     #####  # # ##     ##    # #     ## #  # ## # #      #######  # ## ## ###  #  #### # ####   ### ## ######
### ##  # #  ##      # ##### # #   ###### ##   #### # # # ###    ## # #  ## # # ## ##      # #  #  #        # #
# ##### # ##  ###### ### ##### ## ## ##    ###   ## #######   ####    ## ##     #   # ######   ### # ######## #
#  #      #  ##  ##   ##  # #  ## ##  ## ####  ####### # ## #### #### ## ## ##### ###    ### ### ### ####   # #
##   # ## ## ### #  #  ## # ##     # ##   # ## #  ##              ### ##            ## ### # ##   ## #  # ### #
### ####           ## ### #  #### ##  ## ##      ##  ########## ###    ## #### ######         # #### # ## # # #
########### # ### ##### #   ##    ## ##   # ### #### # #      ### #### #     #      ## #### #    # #    #     #
## # # #    ##### # ##    #######  # #  #     #  # # #   ####  ## ##   # ## ### ######   ######### # #### #####
#    # ## # ##    # ### #  # #  # ##   ### ##### # #   ### #####   ### #  #   # ### #  #      # ##    ###     #
#### # ##########     ### ## ## #  ###   ### # ### # ###       ## ## #   ### ####     ## ####    # ####   # ###
#       #### # #### ####  ## #    ## # ####     ##       ######## ##   #  #### ### #####    #### # # ## ##### #
###### ## #      ##  # ## #  ## ###  #      ###### ## ##      ##   ## ##### #  # #     # ##### ### #  # ## ## #
#      ## ###### ### # ## # ###  ###   # #### ## # ############### #   ## # # ## # # ##### # #  ## ##       # #
###### #  # #    #   # ## # ##  ## # ###  ##   #     # ####  # ###   #             ######    # ##  #  ####### #
## # # # ## #### ###   ##    ##  #    ## ##### # #####      ## #   # ## # # # ####  ## #  #### ### ##  # #  # #
#        ## # #  #   ####### ## ## ##### ## #    ###   # # ##  # ############    ##  # # ####  # # ## ## # ## #
## #####    # ## ### ## ## # ## #      # #    ####   #########      ## # ####### #####      ##              # #
######   ## # #    # ## ##   ## # ###########   ## ###  # # ## # ####     # ## ### # # ####### ## ## ######## #
####   ###    # ## # ##  ## ##  # ### # # # ## ##      ## # #  ####   ###   ##  ##         ##   ###           #
## ########## ###     ##    ### #   # # #         ######    ##  #   #   ### ## ##  ## ## #### ##### ## ## #####
#  ## #   #    ##### ######       #     # ########### ## ####  ## #####  ####  #  ##  ##  ##      ###   #     #
## #  # # ####  # #    ## # #### ######## #  # ###       # ###       ## ##  ## # ########    ####   ## ########
## ## ###  ####   # ####  #   ###### ##     ## #   ####### # # #### ###### ##       ### ####    # ###### ######
#  ##  ## ## #### # #  # ## ### # #  #  #####  # ###  # ## #     ##### #    # ####### # ## ## ### # # #       #
# ##  ##     # #  # ## #  #     # ## # ## # ##     ##   #    ### # # # # ##    ### #        #   # # #   #### ##
# ###  #### ## ##      # ## ##### ##    # # ## ### ## ### #### ###        # # ##     ### ########## # #########
# # ##  ### ##  ##### ##  #  ## # ## #### # #  # ####   #  #    ## ### ######### ## ###   ## ##  ## #         #
#      ##   ### ##    ###   ##    ##  # # #   ##  # # ### ## ####    #    ## # # #### # #     # ##    # # #####
## # #    #     #####  ####  ####  # ## # # #### ##    #      # # ##########        # # # # #      # ## #     #
####### # #####  ## # ## ###  # ## # ##             ##   ## #      ## ## ##  ## ##### ### # # # ####  # ## ####
#       # #   ##      ## # ## #  #      # ## ## # #  ### #########     #    ##         ## # ###   ########    #
## ##########  ### ##    # ## # ## ########   # # ##   #     ####### #   ## ## # ## ##  ###  ## #  ### # # # ##
#  #     ## ##     #  ## # ## # ## ## ## ##########  # # ### #     #### ###### #  #### #####  # ## #     # #  #
# ## # #       ## ### #                           ## # #  ##   # #    #      # ##    #     ## # #    # # # ## #
############################################################################################################# #
