# #############################################################################################################################################
#        ##        ## #  # # # # ##     ##   ##  ## #  # ## #  #     #   ## ## # # #   # #   # # # #  ## # # ##    # # ## #  ## ## # ## ##    #
######## ######## ### # ## # #   ### #######  ## #  # ## #    ## ##### ###  ## #     # # ###         ##       # ####        ###  # # #     ####
# ## # #  # #     ##  # ## #   ###      ## # ##  # ## ##   ####  ###    ## ##    ####### ##  ### ## ##### ### # ##   # ######   ##     ###    #
# #  # # ## ##### ###    # # ####### ####     ##   #     ### ## ## # ####   ## ###    ## #  ## #### # ##  ###    # #####    ### ## ###   ## ###
# ## # #  # ##    # # ##      ## ##  # ###### ## ### # ##### #   #     ## ###      ####  ##     # ### #  ##   ####  # #  ####    #  ######    #
# #    ## #  #### # #  # # # ### ## ##  ## #   # ##  ##### #   #   # ###    ## ### # ### ## # ###  ## ####### ## # ## ##  # ####   ## #  # ####
# ####  # ##  ##  #   #########  ##  # ##  ## ##  ##  ## # # #### ##   ## #### # ### # # ## ####  ##  # # # # ##       # ##  # # ###    ##### #
# # ### # #  #### # ### #  ## ## ###    ## #   # ##  ##        #########  ##      #  # #     ##  #### # # #      # #####  # ##   # # # ## # # #
# # # # # ## # #  #       ##   #  ##### ##   ###  # ### ######    ##   ##  ## ### # ##   ###  ## # ##       ## ###   # ##   ## ### # ###      #
# #            ## # #######  ### ##  #  ####  ### #       #### ###### ##  ##  ##### ####   ##### #  ##### ######### ## #  ###   ##     # ######
#   # # # # ##         # #  ###   ##   ## #  ##   # # #####  #    ##   ##  # ##  ##  #   #####     ####   ## ### ####  # ## # ###  # ### #  ###
### ########### ######## # ## ###  ###  # ##  ## ## ### # # ##### #  #### ##  # ### ## ####  ## ## ## ###         ##  ##          #### # # ## #
# #### # # # ## # ###  # # ##  ## ## # ## #  ##      #       ## #### ###  ## ## ##          ### ####   ## ### ## ### ### ####### ###          #
#  ##         #   # # ## #  ##  # #  # ## # ##  # ##   ########  ##    ## #  ##  ## ######### # # ####  # # ######   # # #######   ## ### #####
# #### ###### # ### # ## # ####   ## # ## #    ##  ###    ### # ##### ##    ##  ##    #    ## #    # ##       ######           ###      ###   #
#    ###         ##   ## # ##   ###         # ######### ### # #  # #  ### #### #### ### ####    #### ## ### #  #  ## #########   ## # # ### ###
# ######### ### ##  ####    ### # ## ######## # ## #  ##### #   ## # ##      # # #   ## ## #### # ##    ######   ##  # ## ########### #       #
# ## # #  ### # #  ### # ####   # ##  ## ###### #    ###    # #### # ## ###### # ## ###     ##       ##      ####### # ## #      # ## # #######
#  # # # ##     # ###       ### #  # ### #  ##  # #####  # ##  #     #    ## # # #    # #####  # ###### # ##### ##     #    ######  # #  #### #
## # #   ######   # # ####### # # ##   # # #### #       ##### ## ##### #####       ##         ##    # #######    ### #   #### ## # #####      #
#  # ## ## #    ### # # # # # # # ## ### # ##     ####### # # #   ###   ## ## ####  ## #### #######     ##  # # ###  # #               # # ## #
## #  # ## #### ### # # # # #   # ## # #    ### ### #####   #   ### ## ##  #    ###########     #########  ####     ################## ###### #
#  ## # ##   #  #         # ### #        #####    #     ###   ### # #   ##   # ## ### #   # # ### ## ## # ## #  ## ###  #        # ### ## ##  #
## #     ### ## ### ### # # ### # ######## #   #### ##### ###  ##     ##### ####        #####                  ##    ##   ### ##     ###  #####
#    ##### #         ## ### # # # #      #   #       # ## ##  ### #####  ##  ### ##### ### ## ########## # ###  ######  ############  ## ## ###
#### # ##  ######## ##  ###         ###### ### # # ### #   ##        ## ##  ##   ## #####  ####   ###  ### ####  ## ## #### ### #  ##  # ##   #
# ##    ##  ##  ##   #### #### #######  ## ### ###  ## # ###  ### ## #  ## ##  # ##  ## ##  ##  #     ##      ##  #       #       ####      ###
#    ####  ####    # # ## ##         ## ## # ######### #  ###  ######## ## ## ##### ##   # ##  ### # #### ### ###   ## ##   ####### ## # ##   #
#### #  ## ## ### ##   ##  ## ##### ### ## #  ##  ## # ## # # ## ## # #  # ## # ##   ## ## ## ## ##### ##  ####   # ## ## #         ## # ## # #
#    # ##  #  ##  ## #####       #### #    # ### ### # ## # #    ## # # ##         #                 #  ##    ## ##  # ## ## # # ##  ###  # # #
####   ### ## ###  ### ##  ####### #    # ## # # # # # #      ##  # #      # # ######## ###### ### #   ##  # ###### ## ## #  #######   ###### #
#  # #        # ##  ##  ##   ##  # ## ######       # #   ## #  ##     # ## # #       ##      ###############   ##    #### ##   ### ######  ## #
##   ####### ## ## ##  ##  ###  ## ## ## ##  # #####   ###### ### # # #### # ### #####  ## ###   ###  ## ##### ## # ### ###  #   # ## ##  ##  #
##########      ##  ##  ## ### ##  ##  # #  #### # ###      #   # # #    # #   #     #####   ## ## ##  #     ###  #     ##  ## #         ### ##
#  ###   ###### ## ### ##  # # ###  ##     ####  # # # ## # ##### # ### ## # # #####     # #  #  # ## ## ## ##### # ####### #### ## ###### ####
# ## ### ## ###  # # #  ## # #  ## ##  ##### #  ## #   ####### ########  # # #   ### ### #### # ##        ####    #     ##    ##  #     ##  # #
#    # # #  # ##   # # ##  # # ##  ### # # # # ##  # ### # ##      ## ############ #####    ###  ## #######  ###### ####### #### ### ##  # ## #
####   # ##   #  ### #  ## # #  ##  #           ##          # ######   ## # #####  ### ### #### ### ### # ##  # #####  ## # #  #   #  ##      #
#    #    ### # ## # # ###   ##  ## # # # #######  # # # # ##     ## #### #  #  ## # #  ##### #            ##      ###  # ### ### ## ### ### ##
#########       ##     # ### ## ##    # #     ##  #### # #    #####  ##   # ## ##  #   ## ##    # # ######  # ###### # ## ##    # #####    #  #
#  #### ##### # ## ##### ###       ##########  # ## ## # # ##  # ###    ###     ## # #### ## ######     ###     #            # ##  ## ### ### #
# ## #  # #   #    #  ## #   ######### #######       # # #  ## #  ## #### # ######               ## # #   #####   ### ## #####  # ##   ##   ###
# ## ## # # ### ##   ##    #  ## ##     #    ####### # # # ######  #    # #   ## # ## ### ## # # ################  ## ## ### ####### # ## #  ##
# #     # #######  #### ########    ###   # ####  ######## #  ##  ## #### # ###     ##############             ###  ###       #  # # #######  #
# ##### # ##  ####  ##   #  ##   ##   #######    ## #    ### ####  #          ## ######  #  # # ## ####### ###   ##  ########   ##    ## ######
#         ## ##  # ##  ### ### ######  ### #####      ####   # ###   ### ## #  #   #  # ## ##           #### ###  ##  # ##### #### ####   # ###
## # #### ##  ## #  ## # #          ##      ## # #### #  ### # # # ### ######### ### ## ##    # ######### #    # ### ##     # ###   # ###   # #
###### ## ## ##  # ### # # ##################     # ### ##   # # #      ## # # #           # ####     ##    ###### #### ####### ## ## # # ### #
# #     # #   ## # ##        ##  # ##     ##  # #    ##  ### #     #######       # # # # ######### ###### ### # ## ## # ## # ## ## ## # #   # #
#   # #     #       ### ######  ##    # # #  #######  # ##     #####       # ## ## ######## # # #  # # ## ##     # #     # # ##  # ##     #   #
# ######## ### #### ##    ## # ##  # ## ### ## # ####    ## ##       # #################        # ##    #    #####   ##### #  # ## #  ###### ##
# ##   ##### # #     # ####       ##  #####        ## #####  ## ## # #     ## ### ## # ## #####      ##   ##       #####   # ## ## # ###   ####
# ####    #  ####### # ## # #########  ##   ########  # #   ###### # ## ####                 ### # # ## #  ## # ###### ###           #   #    #
### #  ##   ##  ##             #   ###  ### # # # ##### # ### ## # #  #      # #### # # # ##  ######### ##########   # # # #### # ##   ###### #
##  # ##### ###    # # #######   ### ####          ###     #     ### ### #####    ### # #####         ###    # # ## ## #    #######  # ## # ###
#  #### # #  ####### #  ##   # #  ##  # # ### ## #     # #   ## #### ##     ## ####   #    ## ### ##########     #  #  # ##     #### #       ##
## # #      ##   #   ## ## ######### ## # ###### # ## #### #  #    #  # # # ##    ##### # ##   ##        ##  ##### ## ## ## ##### ##########  #
#    # # ##  ###   # ##    ## # #            # ### ##   ## ## # # ## ## # ##### # # ############  # # ######   ##        ##   # #   # # ## ####
#### #######  #### ##### #  #     ###### ###     ###  #  ######## ##  # # ######### # ## # #   #### #  # ##  #    ########  #     #           #
#     # ## ##      ##    ##   ### #####    ### #   ## ##  #     ##### # ### #### #           #    ###### #  #####    #   ## #### ## # # # ## ##
# # #       ## ## ##  ##  # # ##      ####   # # ####### ## ### ##########   ##    # ## ## #### ###### # ##    ####### # ##    #### # # #  ####
# #### #### #  ##  ##  ## # ##### ###    # #####     ##       ### ## # # # #    # ####   #  # ### # #       ####       ###  # ### ########### #
# ## # #      ##  #### ## #   ##    ### ##### ### ####  ########  #    #   ### ## #  ## ###    ##     ## ####### ############      #          #
#### ###### #  ## ##   ## # #  ####   #        ####  ##  ##### ## # #### ########   ### ##  ##    # ####                 #########   ###### # #
#  # ###    ##  # #### ## # ##    ## ### # # #   ## ####                      # ##### #####  ## ### ## ## ## # # ## ### ##       ## ## # ######
## # # ### ##  ## #     # # ## ##  #   # # # # #      ## # # # ## # # # #####            ## ###  ##    ## ## # ###    ###  ## # ######        #
#           ## ## # ## ## ###   ######## ### # # # ####### # # ## # # #     # ## # # ## ##    # ##  ####   # #  ### #  ## ######## # # ########
#### ## # #  ###  ###   ####  #        # #########    #  ########## # # ## ##  #####  # #### ##  ##  ##### ### ## ### ##      ## # #      ##  #
#    #### ##   ####   #    ##### ### ### # ##   ## ##   ##### ## ## # ########### #####    #  ## ###     #  ##     ##  # ####### #   # ## ## ##
## # #     # #  #### ## # ##      #### ###    # ##  ## ### #     ## #                ##### ####### ## ######## # #  ##       # # ## #######   #
#  ### ## ## #### #   # #  # # # ##     #  ########  #   # # #####  #### ######## ##  #######   #   #        ### # ### ## ####       ###  ## ##
## ### #  ##  ##    # # # ## ###  # ##### #### # ##### #         # #####       ######         ### ##### ######## ###    # ##   ### #   # ##   #
####   ##  ##  # # #### # #######                    ### ###########   # #####      # #########      #####     # #### # #    #########      ###
# #  # ### ## ## #    # #   ##    ### ##############  ##       # ##  ####### ##### ##     #   ## ##### # # ####### #### # # #### ## ###########
#   ## #    # #  # # ##### #### #  ##    # #       ##### # #####    ###         ##### ###   ####         # # ## #   ##  ###           ##      #
# # ## # # ##### # ###     # ## ## ### #     ## ###### # #       ##     #######   ##    ###      #########        #######   # #### ##    ######
# # ## # # # # ###   ### #   ####    # # ######### # # ### ### # ## # ###     ## #### #   ## # #   ##      ######## # ##### #    ##### #     ##
###  # # # #    #  #   #### ## #  # ## #                ##   ###### #     ################## # # #    ######             ## ## #   # ##### #  #
##  #### #### #   ### ####  ##   ##  ### ##### # ## ########      # # ###     # # ## # ### ### # ## #     ## ######### #  ###  # #   ## #######
#  ##     ##  ### # #  # ## #  #  # ##       ###  #       ### ## ## #  ## #####              # # #  # ###  #      #  ####   # ## # #          #
## ## ## #### ###   ##    #### # ###### # ##   # ### ###### #  #  # ##  #  ## # ### ### #### ###### #   ##   ###### ### #######  # ## ### # # #
## ## #     # #   # #  ## #    #     ####  # # #  ##        # ## ####  ###       ####      #### ##  ## ##  #     ## #        #####  #   # # ###
#   #### # ##### #### ##  # # ### ##    ## # # # ##  ### # ##  #  ### ###  ### #  ####### ####   # ##   ## ## ####    ## # #     # ## #####   #
### ##   # # ##    ##  ## # #  ## #  # ##  # # #  ##   ###### ###   # # ## ######## # ###      ###### #  # #     ## ###### # ## ##  #  # ### ##
#    ### # #    # ##  ### # ## ## ## # ## #### # #####   ## ### ## ## # #               ## # #### # ### ## ## ####       ### ####  #####  ##  #
# # ##   #### # #  ##   ### ## ## #### ##    # #    ## #         ######   # ####### # #  # ####       #  ###   ##  # # ####### ###       ### ##
# # ## #   #### # ### #  ## ## #     ##### ### # # ##  # # ######## ##### #   ##############  # ## ###########    ####     ###  ##### # ## ####
# #  ### ###    ###   # ### ## ## # ######  ## # # ### # # ## ###      ## # ###    # # ##  ## # ####   ##  #### #    ####### # ##   #####   ###
# # ##     ## #   ### #   #  # ## #    ##  ##  ###  ## ###        ######  # ### ##        ##    # ### ### ##  # ## #              ####    #  ##
###  ## ##### # #   ### ### ## #  # ######  ##  ### #    # # # ####    ####     ##### # #    ##              ##  # ## ### # # # ####   #####  #
#   ##  #   # # # # ### #####  # ##    ##  ##  ## #### # ### # #    #### ## # #   # # ##### #### ###### ####### ##  #  #### # #    ## ###  ## #
# #  ## # #   # # ###       #### #  # #### ###  #  ##  #   ###   # ###    #######   #   ##    ## # ####       ##########  # # # ##  # # # #####
# # ### #### ## #   ## # ####    # ## #      ##   #### # #  ######   ## #### # ### ####### # ##       # # # #            ## # #  ##        # ##
# # ##  ##    # # ###  #    #### #  #### # # ###### #  ### ## # ####### ## # #   #  ###  ####### # # ## ### ########## #  ### ####  # ## #    #
###  ## #  # ## #   ## ## #    ### ##    # #  ### # #####  ## # # ##     # #   ###### ## ##   #### ###    #         #####   #    ## # #### ## #
##  ##  ## #  #### #####  ## ###    ### ## ##       ### ##           ###     #    ##   # #  ### ##   ## # # ## ####     ## ## ####  ### ## ## #
#  ##  ##  ##    #  # ## ###   ## #  #######  ## # ##   ## # # # # #   # ## ## ##  ### # # ##   ## ########  #    ###########    ##      #  # #
## ####### #  #######    # #####  ##   ##    ### #    ###  ### # ### ###############          ###   ##    ## # ######## # # ## #  # ### ## ####
## # ##    ##    #######      ## #### ######   # ## # ####   # #  ##    ##   ### # # # # # ###### #  # ####  #              #### ##  ##  # # ##
#     ## #  ## #    ##   # ####    ## ## ##  # # ####    ## ######## # ### ###       ### #      # ##    ######## ##########   ##### ### ## #  #
### # ## ## #  ### ##  # #    ## ###      ## # #   ### #  # # # #    #         # # # ######## ####### #   # # ##          ## ## # ### ###    ##
#   # ##  #### ####### ### ## ##   ## ## ##  # ## ##   # ##     ## # # # # # # # # #        #    # ######## # ### # #######             ## #  #
## ## ## ###        ## ##   #  # # ####   ## # #   ### #  # # # ## # # ### # # ### # # ###########   # # ##    ############## # ## # # ##  # ##
#  ## ##   ### ## # ##  ### #### #    ## ##  ### ####  # ########  # #   #####  #### #             #      # #### #         ## ########  ## ####
## #  #  # ##   ### ## ##      #### # ## ## ##      ## #       ##### ###     ##   #### ## # # ###### ## #          ### ## ##   #     ####   # #
#  ## ## # #  #   # #  ##### #### ### ## #   ### # ### ## ## #  #  #  ## ### ## ###  #  # # #      #  # # # # ####   ######## ## ##########   #
##  ###  ###### ### ##    ##        ####### ##   #   #  #  # ##   ## ###   #  ###   ### # # ## ### # ## # # #####  #        #             ## ##
#  #####  ##      #  ## # #  # # ##    ######  #### ###### # ## # ## ##  #######  #   ########  ######### #     #### ## # # ## # ##### ##### ##
# ##     ##  ## # ####  # # ## #### # ## #####    #    ##  #  # #  #  ##    # #  ## #        ##   # #   #### #### ############ #     #     #  #
###### #  ## ## #   ### # # #   # #####   #    # ### ##### #### ##### #  ## # # ######### #######     #####    ##   #### ##  ####### # # # # ##
## #   ## #  ## ###   # # #### ## ## #### ## # #  ######   ###    # ### ##      # ## ###    ## #  # ### # ## #    #  ##   ## ##    ##### ###  #
#    # ## ####    ##########           ## #  # ##   #  # # #   # ## ##   ### #### #    ## #  # ## #        # # # ###    #  #    ##  #  ####  ##
# ## ###     ## #   #  ##    # ### # ###    ## ## ### ## # # # #     ## ####        # ######   ## ### #### ### ####  #####   ######## ### ##  #
# ##   ## ## #  # #   ###### #  ## # ##  # ##  ##     ## ### # ## # ##     # # ## # #     ## # ##   #   ######    ###### ## ## ## ##       # ##
#  # #### ## ## ### # ##     # #####  ## # ## #### # ####### ###  #  ## ## # # ## # # ### #  # ## # ##### ##   ##   #     #       #  ##########
# ####     ####   # #  # ### # # #### ## #  ####   #    ## ###   ###  #  # ###  # # #   ### ## ## #        #####  #   ###### # ## # ### #   # #
# ##   # #    ## ## # ## #   #      # #  ##    # # ## #      ## ##### # ##   # ## # # #   #  # #  # ## # #     ## # #      # #  #         #   #
############################################################################################################################################# #
