# #############################################################################################################################################
# #### ##  ## ## ## #   #   # ##   # ##            # # # #  # #    ## #  ## # #  # # ##   # # ##  # # ##  # # ##   # ##  # #   ## # ##    # # #
#  ##   ## ##  # #  ### ### # #  # # #  ###### # #       # ## # ##### # ##      ## # ## ###   ###      ##      ### #  ## # # #### # ##### # # #
##  ## ##   ## # # ##     # # #### # ######    # # ### #      # ###      ## # ###  # ##   ###   #### ###### #####  ## ##      ##  # #  #      #
###     ## ##       ### #     ###  # #    ## # # # ########## # # ######  ### # ##    ### # ###  #     # #  ##  ## #   ## ## ####   ## #### ###
# ## ##  # ###### #   ###### ## ## # ####  ######### ## # ##    # # ## ##  #  #    ####   # # ## ### ### ##  # ##  ## ###### ##   ###       ###
#  #####    #   #### ### #   ##  #   ##   ### # # ##       ## #   # #   ## ##   ##### ###   # ## #       ## ##  ## #  # ## #  ### # #######   #
# ##     ## # # ##    #  ### ### ### ####          #######  #### ## ## ##  #  ####      ###   ## ## #### #   ## ## ## # ## # ##   # # ## ## ###
#  ### #### # ####### ## # #     # #   ###### ####         ####   # #  ### ##    # # #### # #  # #  ## #####  # ## #       #  ### # # #     # #
##   ####       ## ## ## #   ### # # ###  ##  #    # # # #  # ## ## ##  ## ## ######  # # ####   ##     ## ##    # ##### #   ## #   # ##### # #
#### ## ###### ##          ####    # # ## ### ########## ##   ## #  ## ##   # #  ##  ## # ## ### ##### ##  #  # ## ## ######  # ###   ## ##   #
# #     # ###   ## ##### #####  ## # # #    ###     # ## #### ## # ##  #### # # ### ##    ##      ## #  ## # ####  #    # ### #   ## ##  ## ###
#   # #       #    #########   ### # # ### #### ### # #  #          ##  ### # # ##  #####  ###### #    ##  #   ### ## ###   # ### ##  ## ##   #
### ############ ###   ##    # ##  # # #   ## ####      #### # ### ##  ## #   # ###  ## ## # ##     ###### # ###   ## # # #     #  ## ## #  ###
# ###      ########### ###########     ### ## ## ###### ## ####### ### ## ### # # # ##  ## #  ## # ## ##   #  #### #    ### # #   ##     # ####
# ########    # #       # ### # ## ### ##  ## ## #  ###### ## ##    #  #  # # #      ##      ##### ##  ### ##  ##    # ##########  #####    # #
# # #  #   ## #   ##### #          #    ##  # #  ## # ##   #   #### ## ## #   # ########## #### #   ## ##  ## ##### ####  ##   ## ##     #### #
# # ##   # #  ### #   # ## # ## # ##### ###   ## ##   #### ## ## #      # ###     ##  ####  #   ### #   ## ##  ## # # #  ##### #   ##### #    #
# # ## ### ## #######    ### ####### ## # ### #  ## ### #      #   # ##    #  #####  ##  ## ###  #    #  #    ##      ##  # #  ###   ##    ####
#    #######     #    ##  #### ##             ## ##  #  ###### ## ########   ### ###  ##     ### ## #### # ######## #####   ## # # #  ## ###  #
## #  ##   ## ## ######## # #   ### #########     ## ##         ####   ### ####  # # ###### ##    ####   #  ## ## #  ## # #### #   ##  # #   ##
#####  # ######  ## ##    # ## ## ####### ####### ##  ###### ##  # ###     ###  ## # # #  # #### ### ### # ##  #  ## ##    ##  ## #### # # ####
#  ###    # #   ##   ####          #               # ## ## #####     #####     ##      ## # # ## ##      # ###   ##   ### #### #####        # #
# ## #### # ### #### # #  # # ## #   # # #########    # #   # ###### # # ## ##### ## #        ##  ###### # #   #### ###    ##    # # # ###### #
#                        ####### # # ###### ## #   ##     #    ###           #  # ###### # ##    ##   ## # # #### # ##### ##  # ## ###        #
## # ### ## ####### ## # # # #   # ###         ### ## ########     # ## ### ## #### # ######## ######    # #  ##      ##   #### ## ##  ########
##########  ##      #  ###   ######### # # # #  #####  ##    #############   #  ##    # # # #   ########   # ##  #### ####  ##     ### #####  #
# #     #  ##  ## # ## #####  # # ## ##### ####   # ###### #    # # # ## ### # ###### #     ###  ## #  ###    # ## #### #  ##  ### # #     ## #
#   ### ##### ##### #  # # ##         ##   ##   #     ## ###### #        ##     ## #  ##### # # ##  ##  #### ## #  # #    ##  ## ### # #####  #
# # # # ####   ##   # ##      # #### ### #  ## ##### ##  ##     ####### ### # # ## # ## #   #    ##  ## #       # ## ####  ##  #  ##     # ## #
#####        ###### # ############   # #########      ## ###### # ### # # ### #### # ## ### #### ## ##  ### ###    # # ## ####   ##  ##### #  #
## #  ## ## ##   ###### ## ##  # ### # ## # ###  # ##     ##               #   # # # ## #      # #   ## ##### # #### # ## # #  ##### ## #  ## #
#    #####  ## #  ## #      ##               #  ###### ## ######### ## ### ### # # #  # ######     # ## # #   # ##     ##   ## ##### ## # ##  #
# ##   ####### ##      ### ######## # ## # #   ##      #            #  #   ##    # ## #    ##  # ### #  # ### #  ## ####### #    ##  ##      ##
######## ##  ###  ## ###    # #     # #### ## ###### ### # #### ########## ##### #      # #########  ## # #   # ##   ## # # ## #####    ## #  #
#     #  ### ##########  ##     # # # #    ##### # ###   # #    #  # ## #  # #   ###### ### #  ## ## ## # ### #  ## ###   #  # ##    ##### # ##
#####   ##      ##  #   ### ### # # ########   #   #   # # ### ### #    ## # ## ##       ## # ##     #          ##  # # #   ##  # # #### ######
## #### ###### #### ### # ###   # # #    ##### ### ##### #######     ##       #  ###### ##  # ######   ##### ##    ## #### ##  #### ##    # # #
#        # ###  ##  # ### ######### #### # #   ##  # ####### ############## #   ### # #  ##    ###   # ###########     ##  ###  ##   # ####   #
########       #### # ###   # ## ## #    # ###    ## # ##    # ####         ## ##     ## #### ## #######   ##  #   # # #  ## # ##  #        ###
## ##  ##### #  ##  # # ### # #  ####### # # #### ##   #  ##      ###### ####   ##### #  # ## ## #    ####  ## ### ###### ## # ##### ######## #
#   ##     #### ###             ## # #   # # ## #  ### ##########   # ######## ## ### ## # ##    ## # #  ## #   #    ##    # # # ##     # # # #
### ######  # #   ## #### # ###      ###        ##  ## # ##     ###                   ## #  #### ## #### #  ###   ####  ## # # #    #####   # #
# # # # ### # ## #####  ############ # ## # # #    ##     #### ## #### ##### # ## ### ## # ##     #  ##  ## ##  # #  # ##  # # ### ### ## ### #
#       #   # #   # ###  # #    #       ##########  ### ### ## ##  ########### #####   # #  ##### ##  ## ## ### ### ####  ##    ## ##       # #
# ## ##   #     #     ##   # ## ####### ## # ## ### # #      #  ##         ##  #     #   ## # ##   # ##  ## #    ##  ##  #### ###  #  # ##### #
#  ###  # ## # ## ### #### ####          #      # #   ######   ##### ## ##    ##########       ###   ###  # #### ## ##  ##      ##   #####    #
####   #############        #   # # ## #   #### #   #  # # ### ## #  #   ### #####       ##### ### #   ##         #  ##  ## # ##### ## # ## ###
#    ### #    ## # # ###### #########  # ####     ####     # # ## ########## # # ########## #  # ##### ##########   ##  ##### # ##   # #  # # #
######## ####         ####     # # #  ## #    # #  # ## ## #      ### ## #   #    ###     # ## # ##  #  ## # #  ### ### # ##     ## ## # ##   #
# ##   # ##   # ##### #    ###   # # ###### # # ##   ####    ## #     ## ### ## # # #####      #  ## ## #    ## #   # # #  ### #### ## #  # ###
# ####      #####     #######  #     ## # ##### ## # # ## # ######### ##  ####### # # #   # ##   ##  #  ####  # ### # #   ###   ##   #   ## # #
# #  ######### ########       ## # # ##         ## ###    # #  # #    ### # ## #      ########## ### ## # ### # # # # ###  #  ##### ## ###    #
# ##     # ##   ####    ## ## #  ###  #########  ########## ## # ####       #  ###### # ## #         #     #    #       ##   ##  #   # #   ####
#    # #      #    #### ##  ######   ### ###    #### ##     #         ## ## ## ##  ##        ## #### ##### #### # ######## # ## ## ### # #    #
## # #### ### #### # ####  ### ##### #       ## #       # # # # ## ## #  #      ## ####### #  ###      ### ###      ## # ### ##     ## # ### ##
#  #### ####  #      #  #####     ######### ################# # ######## # # ##     #      ##  ## ### ##   # ## ### #  # ##     ###      ######
##### # ## ######### # ## #   ### # #       ##                # #   ############ ## # # # ####  ####   ###      # #### # #  # # ###### # # ## #
#   # # #    ## ##        ### #       ### # ########### # # #######   #  ## ######    ###### ##### ###  ##### #    ##  # ## ##### ######      #
###   # #### #   ####### ## #### ## ###   # #         #########     #   ##   ## ## ##### # #  ###    ## #  ###### ####   ##   ##      ### # ###
#####    #   ###     #    # ## # ## ##  ###### # #### ## #    ######### #  #       ##      ##     ##      ##       ##  ###  ###  ###### ##### #
# #### # ### #######   ##    # ###  ### #    # ###### ## #### #           ##### # #### ###  #############  #######  ## ##  ## ##  ####     #  #
#   ####             #######    ## ##   #### ###       # ###    ########### ##  # ## ### ## # # ## #   ## ## ## #  ##  ###       ##    ###   ##
###      #### # ## # #  # #### ### #### ##   ######### # #   # ## ###          ## ## #             ### #        ## ### # # ## ## ### ###### ###
# #### # #    # #######          ### ####### # # ## ## # ## #####   ### # # ## #  #    # ## ### ##   # ######## ## # # # #  ###  #        ### #
# ##   ### ## # # # # ##### ## ####   ###    # #             ## ###     # ###### ### # #### #    ###     # # #     # # # # ####### ### ## ##  #
#    ###   #### #     ##    #   ##  ### #### # #### # ## # # #   #### # # #        #####    # ##########       ###            ###  # ####    ##
############ ##### ##  ######## ## ## # ## # # # ####  ##### # #   #### # ### ## #### ########## #    #  ### # ####### ######## # ##    #######
###     ###   ######## # # #    #                     ###    ### # # ############# #   ### # # # ## #   ##   ### #      ### # # # #  # #####  #
# #### ## ### # # ##       ## #   # ## ## ### # # ## ## ##########     # #  ### ## ###            #####  #######   ## #           # ## ##  ## #
# ## # #  ##         ### #    ## ##  #### #   ########             # # # ## # #    # ## ## #### #       ### #  ### #  # ## # # ##    #### ##  #
#  # # ##    ###### ###### ####  ## ####  # # ## ###### ## ###########      # ####      #  ######## # # #   ##     ## ###  ### ### #  # # #  ##
##     ####### ######      ##   ##  #    #### #   ## #  ##### #  ## #  ####      ###### ####      ######### ### ####   #######  ## ##       ###
######  #####     #### ###  ###  ## ### ## ## ### ## #### # # ## #    ###   # ##    # # #    ####  # # ## #     #### #    ##   #####  # ##### #
# #####       # #      ##  #### ##########  ###      ###           ## # ## ##  ## #   ### ##### ## # #      # # #    # ##### #  #  ## #       #
#       ## ## #### # # #  ##    ## ## ###  #### # ## # ####### ### #  #    ## ##### #  #####         #### # # # ## # #     # ##   ##### #######
# ##### #  #  #    ########### ##     # ##      ####   ##      #   ## # # #####     ##   # #########      # # # #  #### # ##### #### ##       #
####    ##### # # ##            # # #    # # # ##    #    # ## ### #  # # ##    ########    #     #### # ## # ####    # #   ##        # ## # ##
## ### ##     ######### # # ## ######### ### #  ####### ########## ## # ###### ##     ##### #####      # ## #  # ## # # # # ### ## #### ## #  #
#  #    # ### ## #      ######## # #         ######## # ###        #  # ##   ##### ##  ## # # # ## ## ## #  #### #  # # ### # # ##   ##### # ##
##   # ########    # ## #  # ##      # ## ######        # # # ### ### #  ###  # ######             #  #  ##  ##    ## # ##    ##### ## ##  #  #
### ##  ##      # ######## # ###### #######    #### ## ##   # #   ##  ####### # # # ############# ## ###  ## #  # ######### ###         ## # ##
#    ## ### #######          # # #  #       ##      #  #  ##### # #  ##     #       #             ##   ## ## ## #      ##    #### ## # ### #  #
### ##### ###       # ### ##       ## #### ##  ### ### ## #     ########### ####### ######## ## # ### #####   # # ####  ## #  ##  ####   # # ##
#     ##  ### ##### ####  ## # # #######   ### # ### # #  ### # ##### ####  # ## #           ## # #    ##   #####   ## ##### ####    #######  #
## ##  ## #   #      ##  ##  ###### ## # # # ### ##    # ######## #      ##        ####### # ## # ## ######  ##   # ## ## #    ## ##       # ##
#   ####    ####### ######## #           # #        ## # #          # ##    # # ## # ###   # #  # ###### ###  ## ## ## ## # # ##  ## # # # #  #
# # #  ######        # ### ### # ## # ## # ## # # ###  # ### # # # ##  ## ##### ####   ##### # ####        ## ####   # #    #  ##  # # # # ## #
# # ## #   #  ### ####         #### # #  ######## #   ## ###########  ###### #### #  #       ###    ###### #    ## # ##### ###### ## # ########
# ####   #   ##     ##### # ##  ##  # ######      ######## ## # # ###  ##     #     ## ## # ###########      # ##  #####     ##   ## #    #   #
# ##   # ## ##### #  ########  ##########  ###### ## # ##             ####### #####  # #  #    ### ## #### ### ###     ## ##  ## ##  ## #   # #
# ## ########     ####     ### #  ## ## # ## ##   #     ######### ## ##       # ##  ##### ## ###           #    ## # # #  #  ### ### ## #######
# #####   ##### # ##   # #   ####  #         ##########  ###    ########### #      #####  #    ########### # ## ## ### ## # ##     # ##   #####
### # ### #     ###  # ##### ## ## ######## ## # ## # ## # #### ## ## ##  ######## # # ## ####### #        # #  ##   ###  # ## # ######## # # #
#     #     ### ########  #  #      # #               #    ## # #      ##  # # ##  #    ###### #    ### # #####  # # ##  ####  #     ##       #
##### # # # ##  #  ## ### ## ## # #   ## ## # ## #### ### ##  # ###### ###        ## ##  ##    #### ##  #   ##  ## #####    ## ## # ##### # # #
## ## ######### ##              ##### ##### #######        ## #  # ##    #### # #  #####  ####      ### ## ##  ##      ## ###   # #  # ## #####
#      ##        ########### ## ##### # # ##### # ## ##### ## ## # #####  #   ######## ## #    ## # #    # ## ### ## # ##   ## #######        #
###### #### ######   ####  #  ### #        ## # #  #####            # ###   # ##            ## ## ##### #####   #### #  ## ##   ###    #### # #
##     # ######### #    # ## ##     ######      ##       # ## ### #    #### # ## ###### # # ##  # ##        ## ###   # ##  ## ### # # ##    # #
#  ###   # ##      ## #   ## ###### #      ## #    ##### ###   ####### #    #  #####    ### ## ####  # ## ###    ## ## ## ### ##    # ##### # #
## #   #      # ####### #  ### ##   ## ## ##########     #### ## #####   ## # ###    # ###  #     ## # ##   ## #  ###  ## ##  ## # #### #   ###
#  ##### # ## ### # ### ##  #     ######### ### ###### # #    #   #    # #  ### ###### ##  ### # ##### ## ###### #####  # ## ##### # ## ###   #
# ##     # #####      ##### ### ###                #   #### # ### ## # # # ##          #  ##   # #     ##      # ##  # ## #    ##  #    ##  # #
###### ##### ##  ## #  # #   ##################### ## ####  # #      # # # #  ## # # # ##  # # # ## ## ## # ########   ##### ##### ## #    ####
## #   ###      ###### # ## ## ## #######             #    ######## ## # # # ############# # # # #####  # #    ##  # # # ##     ## ## ## #    #
#    #   ### # ##            #            ## # ### ## ## # #        #  # # # #     #####   # # ###     ## # # ####   #   ### # ##  ####  # # ##
###### ###   ######### ## ##   # # ### # ##  ####   #### ##### ## ### ## # # #### ## # ### ####### ## ##### ###  ### # #   ###  ##   ### # # ##
#       ####### ### ## #  ### ## ###   #  ##### ### ##   ### ####  ##### # #####             ##    #   ##       ##   ### #  ## #### ##   ###  #
# ## #### ##           ## # # #  ### #########      ### ##    #   ##     #####   #### #### # ### #### ##  # # # ## #   # # ######    ## ##   ##
######     ######## # ##  #   ## #   #         ## #  ## #####   #  # ####### ## ###   #    #  ##   ## ### # # # ## ## ####      ## # #   ## ###
##########  # #     # #  ## #### ###### ########  ## #  #     ### ####     # #  #   #### # # ### # #   ## # # #  # #    ## ### ##  # ## ###   #
# ## ##  ##     ## ###########   #### ##### #    ###### ##### ##    #### #     ### ##    # # # ###### ##  # ### ## # # ##    #  ## ####   #####
#  # ### ### # ##  #   ## #  #####    ##    #### ##   #####   #  # ##    #####   # #  ## # # #  # #   ## ## ##   # # #  # # ## ##  ##   #     #
##       # ######### #    ## # ###### #####       ### #     # ## #  ########## # # ##  #####   ##   # ## ## ## # ##### ####  #  ##  ### # # # #
### # ##         ### ####      # #      # ## # # ####   ##### ## # ##          # # #  ##     #  ### #  # ##  ###  ##      # ## ##  ##   # # ###
#   ###  # # # #     ####### #     ## #      #####    # ##    #  ########### ### # ##  #### #####   # ######   # ### # ####  ##### ### ## #   #
# # #   ## # # # # # #       ## # ##  ## # # #     # ## ## # ###  ##           # # #  ##     ##   # #     ## # #   # #    ##   ##    # ## # # #
############################################################################################################################################# #
